역명,요일,00시11시,11시17시,17시24시,총합,평균
가락시장,금,71509,58189,73629,203327,67776.0
가락시장,목,73742,55091,67826,196659,65553.0
가락시장,수,83134,63386,77969,224489,74830.0
가락시장,월,79734,58693,70279,208706,69569.0
가락시장,일,16379,37958,35688,90025,30008.0
가락시장,토,30932,57325,39730,127987,42662.0
가락시장,화,83778,62198,75902,221878,73959.0
가산디지털단지,금,384772,76147,57039,517958,172653.0
가산디지털단지,목,403870,74398,49550,527818,175939.0
가산디지털단지,수,466530,81381,57743,605654,201885.0
가산디지털단지,월,444386,74018,51569,569973,189991.0
가산디지털단지,일,23067,59691,27844,110602,36867.0
가산디지털단지,토,44708,74449,33829,152986,50995.0
가산디지털단지,화,472420,80669,56502,609591,203197.0
강남,금,426120,257781,236827,920728,306909.0
강남,목,436438,236064,195142,867644,289215.0
강남,수,507227,267044,222157,996428,332143.0
강남,월,487476,254316,190387,932179,310726.0
강남,일,66658,174059,106065,346782,115594.0
강남,토,171525,303086,146677,621288,207096.0
강남,화,516703,266541,215168,998412,332804.0
강남구청,금,124571,42697,30009,197277,65759.0
강남구청,목,126558,41040,26292,193890,64630.0
강남구청,수,147267,46737,31281,225285,75095.0
강남구청,월,135107,40956,27120,203183,67728.0
강남구청,일,22120,27641,14221,63982,21327.0
강남구청,토,44780,48108,19545,112433,37478.0
강남구청,화,149142,45157,30107,224406,74802.0
강동,금,59186,46725,97101,203012,67671.0
강동,목,61495,44614,95536,201645,67215.0
강동,수,68891,50787,108330,228008,76003.0
강동,월,67354,47432,101500,216286,72095.0
강동,일,16092,35817,45066,96975,32325.0
강동,토,25707,51545,56118,133370,44457.0
강동,화,71116,50529,108876,230521,76840.0
강동구청,금,35221,29190,57783,122194,40731.0
강동구청,목,36890,27716,58783,123389,41130.0
강동구청,수,41516,31891,67355,140762,46921.0
강동구청,월,39227,29876,62633,131736,43912.0
강동구청,일,7793,17925,23297,49015,16338.0
강동구청,토,12011,26391,29722,68124,22708.0
강동구청,화,41982,30804,67568,140354,46785.0
강변(동서울터미널),금,59784,100831,180005,340620,113540.0
강변(동서울터미널),목,61111,89876,159089,310076,103359.0
강변(동서울터미널),수,65672,102415,187784,355871,118624.0
강변(동서울터미널),월,65921,97253,171583,334757,111586.0
강변(동서울터미널),일,32759,85992,87754,206505,68835.0
강변(동서울터미널),토,52872,112901,98231,264004,88001.0
강변(동서울터미널),화,64193,94514,181239,339946,113315.0
강일,금,21,6,0,27,9.0
강일,수,454,774,2094,3322,1107.0
강일,월,406,754,2209,3369,1123.0
강일,일,140,727,980,1847,616.0
강일,토,427,1115,1099,2641,880.0
강일,화,409,776,2157,3342,1114.0
개롱,금,17416,18378,37337,73131,24377.0
개롱,목,17665,17785,37814,73264,24421.0
개롱,수,20001,20299,43234,83534,27845.0
개롱,월,19204,18973,40142,78319,26106.0
개롱,일,5748,12496,16091,34335,11445.0
개롱,토,10115,17585,20484,48184,16061.0
개롱,화,20043,19826,43151,83020,27673.0
개화산,금,12608,15019,28287,55914,18638.0
개화산,목,12877,13860,27870,54607,18202.0
개화산,수,14777,16385,32051,63213,21071.0
개화산,월,13728,15514,30201,59443,19814.0
개화산,일,5341,11606,13075,30022,10007.0
개화산,토,7187,15839,16737,39763,13254.0
개화산,화,14616,15745,32039,62400,20800.0
거여,금,19819,21123,43899,84841,28280.0
거여,목,20072,19735,44096,83903,27968.0
거여,수,22748,22378,51174,96300,32100.0
거여,월,21726,21167,47392,90285,30095.0
거여,일,6554,14049,17896,38499,12833.0
거여,토,12424,19530,23411,55365,18455.0
거여,화,23114,22228,50887,96229,32076.0
건대입구,금,121535,161194,262865,545594,181865.0
건대입구,목,123578,145106,227135,495819,165273.0
건대입구,수,141461,165058,264932,571451,190484.0
건대입구,월,135855,158596,237489,531940,177313.0
건대입구,일,39401,172040,145911,357352,119117.0
건대입구,토,67226,224817,183138,475181,158394.0
건대입구,화,142946,160090,258036,561072,187024.0
경복궁(정부서울청사),금,99627,53194,43987,196808,65603.0
경복궁(정부서울청사),목,103439,48071,39333,190843,63614.0
경복궁(정부서울청사),수,119875,53829,45659,219363,73121.0
경복궁(정부서울청사),월,111513,46810,39104,197427,65809.0
경복궁(정부서울청사),일,24909,58896,21635,105440,35147.0
경복궁(정부서울청사),토,33271,78114,29774,141159,47053.0
경복궁(정부서울청사),화,118957,49613,43942,212512,70837.0
경찰병원,금,29596,20495,35040,85131,28377.0
경찰병원,목,30694,19846,35075,85615,28538.0
경찰병원,수,35237,22644,40609,98490,32830.0
경찰병원,월,34134,21276,37412,92822,30941.0
경찰병원,일,5034,10843,13946,29823,9941.0
경찰병원,토,8792,15445,17381,41618,13873.0
경찰병원,화,35129,22411,40766,98306,32769.0
고덕,금,22768,26625,47938,97331,32444.0
고덕,목,23066,25540,47087,95693,31898.0
고덕,수,26799,30042,54748,111589,37196.0
고덕,월,25200,27496,50884,103580,34527.0
고덕,일,7489,16431,18504,42424,14141.0
고덕,토,16081,23277,23246,62604,20868.0
고덕,화,26522,29499,54749,110770,36923.0
고려대(종암),금,23831,20040,38795,82666,27555.0
고려대(종암),목,24973,19191,37121,81285,27095.0
고려대(종암),수,28654,21796,42783,93233,31078.0
고려대(종암),월,26809,20173,39182,86164,28721.0
고려대(종암),일,5922,15260,20432,41614,13871.0
고려대(종암),토,9741,20147,24755,54643,18214.0
고려대(종암),화,28246,20913,42207,91366,30455.0
고속터미널,금,190336,235067,210354,635757,211919.0
고속터미널,목,196319,202509,142181,541009,180336.0
고속터미널,수,216121,230169,174138,620428,206809.0
고속터미널,월,203019,210356,141658,555033,185011.0
고속터미널,일,90405,228326,133576,452307,150769.0
고속터미널,토,152338,298423,138300,589061,196354.0
고속터미널,화,215010,214798,156114,585922,195307.0
공덕,금,178686,77282,114813,370781,123594.0
공덕,목,183878,72889,105511,362278,120759.0
공덕,수,215045,83478,122562,421085,140362.0
공덕,월,203132,76839,107874,387845,129282.0
공덕,일,20819,48564,44607,113990,37997.0
공덕,토,41720,75620,61002,178342,59447.0
공덕,화,217892,82187,119967,420046,140015.0
공릉(서울과학기술대),금,25596,34389,70793,130778,43593.0
공릉(서울과학기술대),목,25562,32536,66300,124398,41466.0
공릉(서울과학기술대),수,29260,37594,77182,144036,48012.0
공릉(서울과학기술대),월,27687,36017,71968,135672,45224.0
공릉(서울과학기술대),일,9372,27065,34648,71085,23695.0
공릉(서울과학기술대),토,14235,36529,42882,93646,31215.0
공릉(서울과학기술대),화,29302,36536,76988,142826,47609.0
광나루(장신대),금,32827,34150,61644,128621,42874.0
광나루(장신대),목,33890,31820,60380,126090,42030.0
광나루(장신대),수,37983,36948,69868,144799,48266.0
광나루(장신대),월,35003,33012,64311,132326,44109.0
광나루(장신대),일,20726,29668,25880,76274,25425.0
광나루(장신대),토,27426,37257,32911,97594,32531.0
광나루(장신대),화,37532,35891,69749,143172,47724.0
광명사거리,금,42459,69623,137976,250058,83353.0
광명사거리,목,42292,64972,134629,241893,80631.0
광명사거리,수,47546,76115,155290,278951,92984.0
광명사거리,월,44918,70200,144220,259338,86446.0
광명사거리,일,21071,55001,53984,130056,43352.0
광명사거리,토,33357,75960,74829,184146,61382.0
광명사거리,화,46839,73120,154185,274144,91381.0
광화문(세종문화회관),금,223097,69769,48093,340959,113653.0
광화문(세종문화회관),목,234398,67564,39737,341699,113900.0
광화문(세종문화회관),수,272197,76289,44260,392746,130915.0
광화문(세종문화회관),월,253095,66009,36630,355734,118578.0
광화문(세종문화회관),일,25855,63980,20492,110327,36776.0
광화문(세종문화회관),토,36038,82970,27677,146685,48895.0
광화문(세종문화회관),화,274364,72523,43939,390826,130275.0
광흥창(서강),금,35741,21704,36002,93447,31149.0
광흥창(서강),목,36798,20933,35020,92751,30917.0
광흥창(서강),수,43426,23873,40518,107817,35939.0
광흥창(서강),월,39701,22564,37020,99285,33095.0
광흥창(서강),일,8973,16526,15681,41180,13727.0
광흥창(서강),토,10983,20192,20183,51358,17119.0
광흥창(서강),화,43631,23838,39799,107268,35756.0
교대(법원.검찰청),금,252219,146536,122058,520813,173604.0
교대(법원.검찰청),목,258733,144083,111760,514576,171525.0
교대(법원.검찰청),수,300245,164632,130423,595300,198433.0
교대(법원.검찰청),월,282721,148160,111768,542649,180883.0
교대(법원.검찰청),일,35120,61263,47603,143986,47995.0
교대(법원.검찰청),토,74011,102105,62131,238247,79416.0
교대(법원.검찰청),화,303508,163482,125613,592603,197534.0
구로디지털단지,금,254501,135909,288084,678494,226165.0
구로디지털단지,목,267718,128845,272515,669078,223026.0
구로디지털단지,수,309471,149200,316410,775081,258360.0
구로디지털단지,월,296290,138424,292164,726878,242293.0
구로디지털단지,일,33082,89206,128325,250613,83538.0
구로디지털단지,토,57209,134912,175679,367800,122600.0
구로디지털단지,화,313598,145258,313725,772581,257527.0
구산,금,10028,18053,34355,62436,20812.0
구산,목,9777,17134,34562,61473,20491.0
구산,수,11144,20047,39838,71029,23676.0
구산,월,10367,19012,37301,66680,22227.0
구산,일,4072,12001,14582,30655,10218.0
구산,토,7529,17519,19217,44265,14755.0
구산,화,11241,19666,40035,70942,23647.0
구의(광진구청),금,44503,64170,149222,257895,85965.0
구의(광진구청),목,45438,59202,145595,250235,83412.0
구의(광진구청),수,51461,69588,168702,289751,96584.0
구의(광진구청),월,49522,65624,156214,271360,90453.0
구의(광진구청),일,13612,44785,63935,122332,40777.0
구의(광진구청),토,23460,65212,82419,171091,57030.0
구의(광진구청),화,52414,67496,168163,288073,96024.0
구파발,금,40188,56074,115319,211581,70527.0
구파발,목,41187,52275,113838,207300,69100.0
구파발,수,46902,59821,131051,237774,79258.0
구파발,월,43335,57763,122687,223785,74595.0
구파발,일,29029,46851,43837,119717,39906.0
구파발,토,38219,62750,56689,157658,52553.0
구파발,화,46700,59168,131179,237047,79016.0
군자(능동),금,56597,63615,151525,271737,90579.0
군자(능동),목,57163,59555,143762,260480,86827.0
군자(능동),수,65821,68782,165571,300174,100058.0
군자(능동),월,62734,63276,151776,277786,92595.0
군자(능동),일,16270,51333,67158,134761,44920.0
군자(능동),토,27200,74052,87677,188929,62976.0
군자(능동),화,66470,66444,165825,298739,99580.0
굴포천,금,15084,23268,65532,103884,34628.0
굴포천,목,15457,21161,64230,100848,33616.0
굴포천,수,16985,24606,73387,114978,38326.0
굴포천,월,16318,22995,68442,107755,35918.0
굴포천,일,5846,17426,24555,47827,15942.0
굴포천,토,9427,26638,34240,70305,23435.0
굴포천,화,17114,23109,73858,114081,38027.0
굽은다리(강동구민회관앞),금,15717,25785,56857,98359,32786.0
굽은다리(강동구민회관앞),목,15793,24244,56196,96233,32078.0
굽은다리(강동구민회관앞),수,17803,28425,64559,110787,36929.0
굽은다리(강동구민회관앞),월,16778,26376,60700,103854,34618.0
굽은다리(강동구민회관앞),일,7246,19010,24941,51197,17066.0
굽은다리(강동구민회관앞),토,10222,27403,33008,70633,23544.0
굽은다리(강동구민회관앞),화,17568,27036,64665,109269,36423.0
금호,금,12591,23369,50990,86950,28983.0
금호,목,12311,22343,50388,85042,28347.0
금호,수,14118,25619,58419,98156,32719.0
금호,월,13584,24297,53329,91210,30403.0
금호,일,6247,16900,21812,44959,14986.0
금호,토,9255,24094,27629,60978,20326.0
금호,화,13890,25554,58139,97583,32528.0
길동,금,20823,27415,44211,92449,30816.0
길동,목,20986,25789,42218,88993,29664.0
길동,수,23964,29449,49090,102503,34168.0
길동,월,23105,28522,45109,96736,32245.0
길동,일,6716,18695,20232,45643,15214.0
길동,토,12436,27288,26427,66151,22050.0
길동,화,24150,29204,48270,101624,33875.0
길음,금,33197,53310,127901,214408,71469.0
길음,목,34826,50848,127395,213069,71023.0
길음,수,38839,59364,147949,246152,82051.0
길음,월,36590,55297,137353,229240,76413.0
길음,일,15344,35392,50206,100942,33647.0
길음,토,23223,51504,64565,139292,46431.0
길음,화,39451,57936,148436,245823,81941.0
김포공항,금,26359,33562,23019,82940,27647.0
김포공항,목,25480,29358,17206,72044,24015.0
김포공항,수,28540,31848,18798,79186,26395.0
김포공항,월,28723,32160,16895,77778,25926.0
김포공항,일,16393,37339,15977,69709,23236.0
김포공항,토,20740,42188,16710,79638,26546.0
김포공항,화,28435,30939,17250,76624,25541.0
까치산,금,30369,76329,206504,313202,104401.0
까치산,목,30088,70746,202256,303090,101030.0
까치산,수,33698,84163,234529,352390,117463.0
까치산,월,32649,77796,218469,328914,109638.0
까치산,일,16676,57963,88835,163474,54491.0
까치산,토,23460,82198,115808,221466,73822.0
까치산,화,33719,80440,233635,347794,115931.0
까치울,금,11535,17793,50817,80145,26715.0
까치울,목,11597,16164,50500,78261,26087.0
까치울,수,13149,19301,58374,90824,30275.0
까치울,월,12282,17338,54362,83982,27994.0
까치울,일,5646,15572,19174,40392,13464.0
까치울,토,7808,20748,26698,55254,18418.0
까치울,화,12921,18130,57627,88678,29559.0
낙성대(강감찬),금,47565,67415,173797,288777,96259.0
낙성대(강감찬),목,47440,61519,171560,280519,93506.0
낙성대(강감찬),수,56101,70943,199834,326878,108959.0
낙성대(강감찬),월,54294,68469,185529,308292,102764.0
낙성대(강감찬),일,22344,60246,88145,170735,56912.0
낙성대(강감찬),토,27904,81103,103292,212299,70766.0
낙성대(강감찬),화,55923,69512,199001,324436,108145.0
남구로,금,92842,35579,60657,189078,63026.0
남구로,목,97527,34728,57190,189445,63148.0
남구로,수,112263,38918,66608,217789,72596.0
남구로,월,107669,36587,61627,205883,68628.0
남구로,일,13917,28161,28928,71006,23669.0
남구로,토,19678,37035,42180,98893,32964.0
남구로,화,113238,38064,65628,216930,72310.0
남부터미널(예술의전당),금,160417,93794,90059,344270,114757.0
남부터미널(예술의전당),목,165946,83415,74258,323619,107873.0
남부터미널(예술의전당),수,189488,95639,89211,374338,124779.0
남부터미널(예술의전당),월,182696,84703,75541,342940,114313.0
남부터미널(예술의전당),일,26714,72606,51330,150650,50217.0
남부터미널(예술의전당),토,57330,102972,53024,213326,71109.0
남부터미널(예술의전당),화,191374,91732,83510,366616,122205.0
남성,금,17966,29815,66511,114292,38097.0
남성,목,17937,28834,66961,113732,37911.0
남성,수,20346,33590,77476,131412,43804.0
남성,월,19849,31063,71392,122304,40768.0
남성,일,7729,21139,29164,58032,19344.0
남성,토,12157,30476,36598,79231,26410.0
남성,화,20768,32296,77302,130366,43455.0
남태령,금,5233,3063,3466,11762,3921.0
남태령,목,6896,2972,3414,13282,4427.0
남태령,수,6337,3394,3977,13708,4569.0
남태령,월,5611,3011,3542,12164,4055.0
남태령,일,1584,2316,1867,5767,1922.0
남태령,토,2216,2954,2452,7622,2541.0
남태령,화,6283,3403,3708,13394,4465.0
남한산성입구(성남법원.검찰청),금,27305,33968,76227,137500,45833.0
남한산성입구(성남법원.검찰청),목,28509,33230,77870,139609,46536.0
남한산성입구(성남법원.검찰청),수,31366,37301,88110,156777,52259.0
남한산성입구(성남법원.검찰청),월,29540,34590,82324,146454,48818.0
남한산성입구(성남법원.검찰청),일,9871,23948,35478,69297,23099.0
남한산성입구(성남법원.검찰청),토,13198,32453,44993,90644,30215.0
남한산성입구(성남법원.검찰청),화,31155,36273,88329,155757,51919.0
내방,금,80804,37053,46351,164208,54736.0
내방,목,82372,35338,44345,162055,54018.0
내방,수,95020,40738,52574,188332,62777.0
내방,월,90591,36999,46490,174080,58027.0
내방,일,13455,23041,21103,57599,19200.0
내방,토,25138,35060,26217,86415,28805.0
내방,화,96356,40213,50866,187435,62478.0
노원,금,99079,151084,222120,472283,157428.0
노원,목,98834,136703,205212,440749,146916.0
노원,수,113667,158710,237260,509637,169879.0
노원,월,112187,152760,216053,481000,160333.0
노원,일,37847,115155,97684,250686,83562.0
노원,토,66939,164145,132682,363766,121255.0
노원,화,115822,155793,234032,505647,168549.0
녹번,금,20212,31840,96218,148270,49423.0
녹번,목,20450,30418,96804,147672,49224.0
녹번,수,23629,35212,111963,170804,56935.0
녹번,월,22411,33029,104668,160108,53369.0
녹번,일,8735,22293,34447,65475,21825.0
녹번,토,12747,32319,47158,92224,30741.0
녹번,화,23637,34481,112689,170807,56936.0
녹사평(용산구청),금,18997,14968,20206,54171,18057.0
녹사평(용산구청),목,19410,13160,15967,48537,16179.0
녹사평(용산구청),수,22256,14709,18756,55721,18574.0
녹사평(용산구청),월,20366,13010,15161,48537,16179.0
녹사평(용산구청),일,5576,20689,11758,38023,12674.0
녹사평(용산구청),토,7771,26365,16970,51106,17035.0
녹사평(용산구청),화,22031,13290,17292,52613,17538.0
논현,금,143812,53799,48184,245795,81932.0
논현,목,146133,50798,41687,238618,79539.0
논현,수,171051,57877,48011,276939,92313.0
논현,월,163403,54496,41703,259602,86534.0
논현,일,18769,33067,21731,73567,24522.0
논현,토,46930,57366,28955,133251,44417.0
논현,화,173997,57313,46706,278016,92672.0
단대오거리,금,25478,28289,60049,113816,37939.0
단대오거리,목,27089,27837,59659,114585,38195.0
단대오거리,수,28983,31173,68230,128386,42795.0
단대오거리,월,27753,28905,63189,119847,39949.0
단대오거리,일,7689,19695,30454,57838,19279.0
단대오거리,토,12715,27352,36779,76846,25615.0
단대오거리,화,28224,29878,68379,126481,42160.0
답십리,금,41121,39650,90654,171425,57142.0
답십리,목,41538,37574,89468,168580,56193.0
답십리,수,47945,42608,103520,194073,64691.0
답십리,월,44969,40667,96193,181829,60610.0
답십리,일,11797,27446,36373,75616,25205.0
답십리,토,18624,39947,47259,105830,35277.0
답십리,화,48216,41710,103320,193246,64415.0
당고개,금,20015,34357,74612,128984,42995.0
당고개,목,19583,32365,72646,124594,41531.0
당고개,수,22489,37434,82823,142746,47582.0
당고개,월,20878,34992,78512,134382,44794.0
당고개,일,17136,28069,35182,80387,26796.0
당고개,토,19219,36008,46668,101895,33965.0
당고개,화,22202,36249,83464,141915,47305.0
당산,금,76151,51537,112270,239958,79986.0
당산,목,78086,48051,105979,232116,77372.0
당산,수,89931,55936,122751,268618,89539.0
당산,월,85988,49688,110716,246392,82131.0
당산,일,16018,38185,43658,97861,32620.0
당산,토,26755,55909,60082,142746,47582.0
당산,화,90393,53612,120771,264776,88259.0
대림(구로구청),금,86205,105373,176050,367628,122543.0
대림(구로구청),목,88680,102015,164685,355380,118460.0
대림(구로구청),수,100777,116883,192162,409822,136607.0
대림(구로구청),월,97763,111880,178286,387929,129310.0
대림(구로구청),일,36786,96361,89804,222951,74317.0
대림(구로구청),토,46390,113359,125962,285711,95237.0
대림(구로구청),화,101136,113652,188805,403593,134531.0
대청,금,29144,24455,46533,100132,33377.0
대청,목,29006,23272,45661,97939,32646.0
대청,수,33568,26322,52583,112473,37491.0
대청,월,31050,24901,48591,104542,34847.0
대청,일,5653,15254,20233,41140,13713.0
대청,토,9699,21095,25313,56107,18702.0
대청,화,33353,26719,52587,112659,37553.0
대치,금,35097,38916,47850,121863,40621.0
대치,목,35626,37300,46234,119160,39720.0
대치,수,40341,41598,53023,134962,44987.0
대치,월,39990,39286,49035,128311,42770.0
대치,일,12689,22409,18665,53763,17921.0
대치,토,25996,35602,23170,84768,28256.0
대치,화,40926,42201,53230,136357,45452.0
대흥(서강대앞),금,31645,24901,33148,89694,29898.0
대흥(서강대앞),목,32435,23702,31974,88111,29370.0
대흥(서강대앞),수,37748,26762,36783,101293,33764.0
대흥(서강대앞),월,35240,24880,33821,93941,31314.0
대흥(서강대앞),일,6127,16542,16442,39111,13037.0
대흥(서강대앞),토,12499,23102,20011,55612,18537.0
대흥(서강대앞),화,37959,26226,36947,101132,33711.0
도곡,금,27933,14879,19276,62088,20696.0
도곡,목,28246,14539,18324,61109,20370.0
도곡,수,32439,16532,21722,70693,23564.0
도곡,월,31571,15162,18757,65490,21830.0
도곡,일,5399,8206,8335,21940,7313.0
도곡,토,11266,14722,9619,35607,11869.0
도곡,화,32704,16265,20770,69739,23246.0
도림천,금,6766,4052,5440,16258,5419.0
도림천,목,6825,4101,5692,16618,5539.0
도림천,수,7939,4814,6647,19400,6467.0
도림천,월,7480,4605,5925,18010,6003.0
도림천,일,1167,2102,2390,5659,1886.0
도림천,토,2717,3810,2893,9420,3140.0
도림천,화,7873,4649,6688,19210,6403.0
도봉산,금,16973,27384,71596,115953,38651.0
도봉산,목,17253,24722,72007,113982,37994.0
도봉산,수,19709,29110,82394,131213,43738.0
도봉산,월,17168,25850,77745,120763,40254.0
도봉산,일,25370,32044,25384,82798,27599.0
도봉산,토,23968,36265,35980,96213,32071.0
도봉산,화,18823,27093,83031,128947,42982.0
독립문,금,24630,23053,30738,78421,26140.0
독립문,목,25013,22121,29753,76887,25629.0
독립문,수,29293,25580,34613,89486,29829.0
독립문,월,27021,23892,31009,81922,27307.0
독립문,일,13199,20153,14649,48001,16000.0
독립문,토,16934,26280,18982,62196,20732.0
독립문,화,29269,24757,34567,88593,29531.0
독바위,금,4179,7926,20181,32286,10762.0
독바위,목,4245,7281,21023,32549,10850.0
독바위,수,4760,8521,23971,37252,12417.0
독바위,월,4099,7851,22480,34430,11477.0
독바위,일,6267,7379,8006,21652,7217.0
독바위,토,5778,9117,10878,25773,8591.0
독바위,화,4464,7978,24173,36615,12205.0
돌곶이,금,16559,23008,50951,90518,30173.0
돌곶이,목,16809,22569,50645,90023,30008.0
돌곶이,수,19740,26310,59781,105831,35277.0
돌곶이,월,18201,24098,55152,97451,32484.0
돌곶이,일,8516,15588,20930,45034,15011.0
돌곶이,토,9704,21438,27862,59004,19668.0
돌곶이,화,19109,24757,58607,102473,34158.0
동대문,금,141043,128118,68678,337839,112613.0
동대문,목,141482,121379,62730,325591,108530.0
동대문,수,165411,140198,72512,378121,126040.0
동대문,월,160000,136489,69435,365924,121975.0
동대문,일,32072,97015,49738,178825,59608.0
동대문,토,72039,135677,41571,249287,83096.0
동대문,화,167048,139452,71631,378131,126044.0
동대문역사문화공원(DDP),금,153467,96889,85075,335431,111810.0
동대문역사문화공원(DDP),목,158367,90406,72723,321496,107165.0
동대문역사문화공원(DDP),수,182603,102719,86392,371714,123905.0
동대문역사문화공원(DDP),월,172248,95631,79075,346954,115651.0
동대문역사문화공원(DDP),일,35996,97064,59219,192279,64093.0
동대문역사문화공원(DDP),토,55764,117485,51181,224430,74810.0
동대문역사문화공원(DDP),화,183634,96718,81950,362302,120767.0
동대입구,금,43746,23027,17256,84029,28010.0
동대입구,목,45539,20559,15490,81588,27196.0
동대입구,수,51450,23414,17907,92771,30924.0
동대입구,월,48125,21018,14872,84015,28005.0
동대입구,일,20606,25526,10683,56815,18938.0
동대입구,토,24466,27153,12551,64170,21390.0
동대입구,화,51229,21846,17698,90773,30258.0
동묘앞,금,56562,81920,49512,187994,62665.0
동묘앞,목,56387,74192,46015,176594,58865.0
동묘앞,수,64695,86383,53101,204179,68060.0
동묘앞,월,60047,77108,49594,186749,62250.0
동묘앞,일,32919,138773,30418,202110,67370.0
동묘앞,토,40063,127615,33903,201581,67194.0
동묘앞,화,64785,81211,52067,198063,66021.0
동작(현충원),금,10932,13770,13492,38194,12731.0
동작(현충원),목,11119,12559,12913,36591,12197.0
동작(현충원),수,12724,15377,15696,43797,14599.0
동작(현충원),월,12161,13584,13678,39423,13141.0
동작(현충원),일,4105,10472,6568,21145,7048.0
동작(현충원),토,5519,11726,7923,25168,8389.0
동작(현충원),화,12683,14617,14985,42285,14095.0
둔촌동,금,25034,26097,44322,95453,31818.0
둔촌동,목,25387,25028,42635,93050,31017.0
둔촌동,수,28662,28546,49287,106495,35498.0
둔촌동,월,27555,26296,45455,99306,33102.0
둔촌동,일,9083,19870,18932,47885,15962.0
둔촌동,토,14544,27449,24597,66590,22197.0
둔촌동,화,28745,27570,48927,105242,35081.0
디지털미디어시티,금,67027,30211,67333,164571,54857.0
디지털미디어시티,목,70386,29171,67350,166907,55636.0
디지털미디어시티,수,81359,33800,77739,192898,64299.0
디지털미디어시티,월,76833,31174,71492,179499,59833.0
디지털미디어시티,일,10633,21207,27006,58846,19615.0
디지털미디어시티,토,17077,28127,34680,79884,26628.0
디지털미디어시티,화,82240,32983,77766,192989,64330.0
뚝섬,금,134870,56416,59311,250597,83532.0
뚝섬,목,140942,52610,53161,246713,82238.0
뚝섬,수,164084,60763,62093,286940,95647.0
뚝섬,월,152581,51105,53669,257355,85785.0
뚝섬,일,15581,53314,28340,97235,32412.0
뚝섬,토,26145,70590,37449,134184,44728.0
뚝섬,화,165852,57050,60148,283050,94350.0
뚝섬유원지,금,15260,26637,49247,91144,30381.0
뚝섬유원지,목,15514,22237,43452,81203,27068.0
뚝섬유원지,수,17228,25658,51979,94865,31622.0
뚝섬유원지,월,15894,22203,45925,84022,28007.0
뚝섬유원지,일,6703,29622,24901,61226,20409.0
뚝섬유원지,토,9479,32473,29190,71142,23714.0
뚝섬유원지,화,16808,23121,50103,90032,30011.0
마곡,금,45014,24862,34024,103900,34633.0
마곡,목,47190,24079,33108,104377,34792.0
마곡,수,53818,27705,38371,119894,39965.0
마곡,월,51055,25253,35287,111595,37198.0
마곡,일,6503,15160,13763,35426,11809.0
마곡,토,11505,21186,17316,50007,16669.0
마곡,화,54388,26975,38392,119755,39918.0
마들,금,16495,34016,82865,133376,44459.0
마들,목,16155,31592,83575,131322,43774.0
마들,수,18266,36426,95575,150267,50089.0
마들,월,17053,33052,90187,140292,46764.0
마들,일,8032,20670,30534,59236,19745.0
마들,토,14940,35373,41443,91756,30585.0
마들,화,17795,34677,96575,149047,49682.0
마장,금,16476,15522,26684,58682,19561.0
마장,목,16740,14880,26345,57965,19322.0
마장,수,19300,17126,30320,66746,22249.0
마장,월,18722,15883,27476,62081,20694.0
마장,일,5433,12797,11594,29824,9941.0
마장,토,8548,17348,15491,41387,13796.0
마장,화,19273,16543,29994,65810,21937.0
마천,금,12439,17987,37061,67487,22496.0
마천,목,12608,16819,36829,66256,22085.0
마천,수,13957,19417,42497,75871,25290.0
마천,월,13163,17684,39282,70129,23376.0
마천,일,8734,13171,16179,38084,12695.0
마천,토,10270,18128,20816,49214,16405.0
마천,화,14156,18833,42437,75426,25142.0
마포,금,71518,35081,56694,163293,54431.0
마포,목,73719,33627,55420,162766,54255.0
마포,수,85091,38652,63845,187588,62529.0
마포,월,80517,35182,56588,172287,57429.0
마포,일,9872,20716,19317,49905,16635.0
마포,토,19164,31844,26789,77797,25932.0
마포,화,86085,38711,63161,187957,62652.0
마포구청,금,37977,34533,68089,140599,46866.0
마포구청,목,38342,33274,66943,138559,46186.0
마포구청,수,43950,37795,77841,159586,53195.0
마포구청,월,41507,35741,71951,149199,49733.0
마포구청,일,10976,26932,31707,69615,23205.0
마포구청,토,15430,35455,38642,89527,29842.0
마포구청,화,44503,37582,78199,160284,53428.0
망원,금,39478,59218,74360,173056,57685.0
망원,목,39883,55010,68409,163302,54434.0
망원,수,46047,62896,78327,187270,62423.0
망원,월,43286,54788,70440,168514,56171.0
망원,일,11950,60781,35496,108227,36076.0
망원,토,19739,82945,47861,150545,50182.0
망원,화,46059,57860,77211,181130,60377.0
매봉,금,67693,26017,36120,129830,43277.0
매봉,목,70949,25669,33758,130376,43459.0
매봉,수,81510,29609,40386,151505,50502.0
매봉,월,77117,26334,34664,138115,46038.0
매봉,일,10491,18145,15234,43870,14623.0
매봉,토,16790,24807,19038,60635,20212.0
매봉,화,82283,28700,38671,149654,49885.0
먹골,금,16584,28103,65924,110611,36870.0
먹골,목,16510,26264,63901,106675,35558.0
먹골,수,18830,30885,73265,122980,40993.0
먹골,월,18087,28977,68451,115515,38505.0
먹골,일,7628,21339,28536,57503,19168.0
먹골,토,12841,32733,37943,83517,27839.0
먹골,화,18747,30178,73941,122866,40955.0
면목,금,26225,43001,99699,168925,56308.0
면목,목,26161,40887,98399,165447,55149.0
면목,수,28937,47548,113007,189492,63164.0
면목,월,28720,44190,105592,178502,59501.0
면목,일,11201,30425,44947,86573,28858.0
면목,토,18261,43389,58037,119687,39896.0
면목,화,29929,45787,113805,189521,63174.0
명동,금,103772,56790,28139,188701,62900.0
명동,목,106288,50824,21568,178680,59560.0
명동,수,125615,57873,25673,209161,69720.0
명동,월,118338,52944,21220,192502,64167.0
명동,일,20900,61408,18368,100676,33559.0
명동,토,32370,84104,25056,141530,47177.0
명동,화,126760,55444,23035,205239,68413.0
명일,금,14319,24843,56767,95929,31976.0
명일,목,13931,23563,57023,94517,31506.0
명일,수,16304,27531,66080,109915,36638.0
명일,월,15453,25894,60219,101566,33855.0
명일,일,7431,17183,20736,45350,15117.0
명일,토,10662,24528,27795,62985,20995.0
명일,화,16330,26533,65965,108828,36276.0
모란,금,10423,15266,15098,40787,13596.0
모란,목,10612,14274,13541,38427,12809.0
모란,수,11500,15804,15577,42881,14294.0
모란,월,10778,14705,13459,38942,12981.0
모란,일,4744,12819,8989,26552,8851.0
모란,토,6795,14912,11927,33634,11211.0
모란,화,11625,15666,14720,42011,14004.0
목동,금,36415,50419,120081,206915,68972.0
목동,목,35870,47173,119322,202365,67455.0
목동,수,41762,55013,138562,235337,78446.0
목동,월,39403,50451,128151,218005,72668.0
목동,일,11743,30098,41194,83035,27678.0
목동,토,20758,45731,55386,121875,40625.0
목동,화,41390,54232,138091,233713,77904.0
몽촌토성(평화의문),금,26680,15970,22705,65355,21785.0
몽촌토성(평화의문),목,27696,15407,21827,64930,21643.0
몽촌토성(평화의문),수,31476,17395,24836,73707,24569.0
몽촌토성(평화의문),월,29185,16560,22659,68404,22801.0
몽촌토성(평화의문),일,7402,14252,10870,32524,10841.0
몽촌토성(평화의문),토,12120,19009,13703,44832,14944.0
몽촌토성(평화의문),화,31582,16387,24379,72348,24116.0
무악재,금,7416,10885,26445,44746,14915.0
무악재,목,7357,10275,26712,44344,14781.0
무악재,수,8613,12174,30829,51616,17205.0
무악재,월,8147,11222,28527,47896,15965.0
무악재,일,3210,7925,10606,21741,7247.0
무악재,토,4980,11117,14076,30173,10058.0
무악재,화,8528,11636,30824,50988,16996.0
문래,금,110045,46956,80575,237576,79192.0
문래,목,114681,44330,76059,235070,78357.0
문래,수,132183,51519,88147,271849,90616.0
문래,월,124931,46812,78682,250425,83475.0
문래,일,15484,36050,29556,81090,27030.0
문래,토,27957,58078,41410,127445,42482.0
문래,화,133735,49694,86946,270375,90125.0
문정,금,160687,42043,53233,255963,85321.0
문정,목,168871,41829,50551,261251,87084.0
문정,수,193464,46899,57885,298248,99416.0
문정,월,184146,41405,52709,278260,92753.0
문정,일,14467,24987,21841,61295,20432.0
문정,토,24746,39209,28560,92515,30838.0
문정,화,195137,45875,57965,298977,99659.0
미사,금,22991,30219,103168,156378,52126.0
미사,목,23183,26993,100806,150982,50327.0
미사,수,26045,31393,116092,173530,57843.0
미사,월,24421,29316,107791,161528,53843.0
미사,일,10231,26354,39623,76208,25403.0
미사,토,16268,37265,52138,105671,35224.0
미사,화,25929,30459,117142,173530,57843.0
미아(서울사이버대학),금,33264,45151,83803,162218,54073.0
미아(서울사이버대학),목,33723,43675,81352,158750,52917.0
미아(서울사이버대학),수,37643,51525,95219,184387,61462.0
미아(서울사이버대학),월,36605,48557,88755,173917,57972.0
미아(서울사이버대학),일,12523,30781,39139,82443,27481.0
미아(서울사이버대학),토,18688,43923,51342,113953,37984.0
미아(서울사이버대학),화,38432,49835,94842,183109,61036.0
미아사거리,금,46815,85704,170483,303002,101001.0
미아사거리,목,47151,79382,163169,289702,96567.0
미아사거리,수,53505,93106,188024,334635,111545.0
미아사거리,월,50005,86798,175414,312217,104072.0
미아사거리,일,23754,65976,73962,163692,54564.0
미아사거리,토,36966,94588,99774,231328,77109.0
미아사거리,화,53372,90658,189107,333137,111046.0
반포,금,26436,18254,16248,60938,20313.0
반포,목,26403,17773,15860,60036,20012.0
반포,수,30062,20907,18707,69676,23225.0
반포,월,28564,18450,16770,63784,21261.0
반포,일,9011,12536,8650,30197,10066.0
반포,토,16971,17880,9298,44149,14716.0
반포,화,29920,19533,18299,67752,22584.0
발산,금,94140,52511,64164,210815,70272.0
발산,목,102578,50832,58001,211411,70470.0
발산,수,117722,59489,67641,244852,81617.0
발산,월,110486,53752,59856,224094,74698.0
발산,일,18023,42782,30295,91100,30367.0
발산,토,34315,64597,39030,137942,45981.0
발산,화,118413,56578,65085,240076,80025.0
방배,금,82409,48728,64299,195436,65145.0
방배,목,85175,47856,62675,195706,65235.0
방배,수,97896,55809,73395,227100,75700.0
방배,월,90943,49406,65908,206257,68752.0
방배,일,15898,29202,29062,74162,24721.0
방배,토,29184,41788,36527,107499,35833.0
방배,화,99658,55624,71677,226959,75653.0
방이,금,23829,21856,33849,79534,26511.0
방이,목,24710,21101,33625,79436,26479.0
방이,수,27759,24019,37912,89690,29897.0
방이,월,26600,21794,34472,82866,27622.0
방이,일,8235,15535,14431,38201,12734.0
방이,토,12615,21104,19031,52750,17583.0
방이,화,27961,23833,37932,89726,29909.0
방화,금,13972,18702,38541,71215,23738.0
방화,목,14294,17411,38255,69960,23320.0
방화,수,16183,20335,44218,80736,26912.0
방화,월,15165,19386,41292,75843,25281.0
방화,일,6433,14342,17616,38391,12797.0
방화,토,7936,19102,22277,49315,16438.0
방화,화,16206,19795,44090,80091,26697.0
버티고개,금,6362,6581,11603,24546,8182.0
버티고개,목,6354,6244,11544,24142,8047.0
버티고개,수,7353,6895,13026,27274,9091.0
버티고개,월,7143,6645,11723,25511,8504.0
버티고개,일,2143,4951,5694,12788,4263.0
버티고개,토,3506,6517,7258,17281,5760.0
버티고개,화,7320,6834,12936,27090,9030.0
보라매,금,36989,22906,46893,106788,35596.0
보라매,목,37996,21777,45846,105619,35206.0
보라매,수,43627,25210,53311,122148,40716.0
보라매,월,40655,23360,49567,113582,37861.0
보라매,일,8669,17262,19694,45625,15208.0
보라매,토,14583,23492,25143,63218,21073.0
보라매,화,43704,24333,52818,120855,40285.0
보문,금,20089,16816,36959,73864,24621.0
보문,목,20311,15565,36033,71909,23970.0
보문,수,23128,17848,41958,82934,27645.0
보문,월,22081,16680,38762,77523,25841.0
보문,일,5632,14187,19485,39304,13101.0
보문,토,8137,17464,23709,49310,16437.0
보문,화,23417,17270,41376,82063,27354.0
복정,금,28434,23189,53118,104741,34914.0
복정,목,30174,22527,52100,104801,34934.0
복정,수,32972,25010,60142,118124,39375.0
복정,월,29523,24415,53921,107859,35953.0
복정,일,10104,17336,20985,48425,16142.0
복정,토,15644,22523,25480,63647,21216.0
복정,화,32766,25125,59066,116957,38986.0
봉천,금,33681,64425,150230,248336,82779.0
봉천,목,33514,60395,148987,242896,80965.0
봉천,수,38457,70675,172912,282044,94015.0
봉천,월,36745,66834,162000,265579,88526.0
봉천,일,15011,45672,66534,127217,42406.0
봉천,토,22615,66573,84810,173998,57999.0
봉천,화,38424,68728,173177,280329,93443.0
봉화산(서울의료원),금,14756,21901,56877,93534,31178.0
봉화산(서울의료원),목,14907,20758,56821,92486,30829.0
봉화산(서울의료원),수,16901,23828,65700,106429,35476.0
봉화산(서울의료원),월,15940,21619,61676,99235,33078.0
봉화산(서울의료원),일,5974,15203,20087,41264,13755.0
봉화산(서울의료원),토,7959,20504,27526,55989,18663.0
봉화산(서울의료원),화,17096,23037,65917,106050,35350.0
부천시청,금,32591,34756,71068,138415,46138.0
부천시청,목,32765,31714,68450,132929,44310.0
부천시청,수,37274,36614,78999,152887,50962.0
부천시청,월,35006,33902,72620,141528,47176.0
부천시청,일,11224,30341,26365,67930,22643.0
부천시청,토,20669,43197,35277,99143,33048.0
부천시청,화,37276,35056,79719,152051,50684.0
부천종합운동장,금,12969,10202,22677,45848,15283.0
부천종합운동장,목,13229,9245,22176,44650,14883.0
부천종합운동장,수,14802,11223,25622,51647,17216.0
부천종합운동장,월,13622,10322,24163,48107,16036.0
부천종합운동장,일,5628,9442,9126,24196,8065.0
부천종합운동장,토,7674,11111,12212,30997,10332.0
부천종합운동장,화,14853,11024,25684,51561,17187.0
부평구청,금,17643,20353,69835,107831,35944.0
부평구청,목,18394,18086,70459,106939,35646.0
부평구청,수,20548,21514,81073,123135,41045.0
부평구청,월,19033,19307,76050,114390,38130.0
부평구청,일,5744,15527,25674,46945,15648.0
부평구청,토,9137,22813,34347,66297,22099.0
부평구청,화,20527,20358,81365,122250,40750.0
불광,금,46998,72806,119327,239131,79710.0
불광,목,48178,68736,114511,231425,77142.0
불광,수,55158,81582,134181,270921,90307.0
불광,월,51589,75464,123457,250510,83503.0
불광,일,36556,62146,51614,150316,50105.0
불광,토,45275,82010,67984,195269,65090.0
불광,화,54402,77617,132859,264878,88293.0
사가정,금,30310,47369,106678,184357,61452.0
사가정,목,30395,44754,102954,178103,59368.0
사가정,수,34707,51798,119190,205695,68565.0
사가정,월,33227,48934,111180,193341,64447.0
사가정,일,16496,35494,45148,97138,32379.0
사가정,토,23288,49596,60255,133139,44380.0
사가정,화,34205,50284,119412,203901,67967.0
사당,금,136272,172129,362033,670434,223478.0
사당,목,142221,159414,331425,633060,211020.0
사당,수,160681,183467,387417,731565,243855.0
사당,월,153473,171468,342494,667435,222478.0
사당,일,61979,152217,162220,376416,125472.0
사당,토,88385,210910,205734,505029,168343.0
사당,화,162258,177112,375467,714837,238279.0
산성,금,10070,17992,45528,73590,24530.0
산성,목,10958,16988,46398,74344,24781.0
산성,수,11523,18750,52788,83061,27687.0
산성,월,10885,17665,48943,77493,25831.0
산성,일,6747,14440,20830,42017,14006.0
산성,토,9424,19700,26338,55462,18487.0
산성,화,11806,18216,52136,82158,27386.0
삼각지,금,49109,26017,39394,114520,38173.0
삼각지,목,51670,24714,35129,111513,37171.0
삼각지,수,58059,27640,41528,127227,42409.0
삼각지,월,52560,24708,35140,112408,37469.0
삼각지,일,8761,22054,19041,49856,16619.0
삼각지,토,13688,32652,26009,72349,24116.0
삼각지,화,58701,26438,39623,124762,41587.0
삼산체육관,금,5824,10610,31852,48286,16095.0
삼산체육관,목,5732,9744,32388,47864,15955.0
삼산체육관,수,6450,11243,37223,54916,18305.0
삼산체육관,월,5903,10310,34594,50807,16936.0
삼산체육관,일,2542,8942,12065,23549,7850.0
삼산체육관,토,3934,12219,16066,32219,10740.0
삼산체육관,화,6490,10987,37969,55446,18482.0
삼성(무역센터),금,339816,133950,80389,554155,184718.0
삼성(무역센터),목,355913,124584,69134,549631,183210.0
삼성(무역센터),수,410113,134870,78134,623117,207706.0
삼성(무역센터),월,384344,119870,65867,570081,190027.0
삼성(무역센터),일,61156,108575,36688,206419,68806.0
삼성(무역센터),토,90753,157365,50430,298548,99516.0
삼성(무역센터),화,413304,129317,74130,616751,205584.0
상계,금,27076,49659,120043,196778,65593.0
상계,목,27257,46794,118935,192986,64329.0
상계,수,30404,53685,136814,220903,73634.0
상계,월,28533,51229,128767,208529,69510.0
상계,일,17581,36778,49450,103809,34603.0
상계,토,23557,51464,67017,142038,47346.0
상계,화,30310,53355,137419,221084,73695.0
상도,금,22174,27895,59926,109995,36665.0
상도,목,22012,26509,58995,107516,35839.0
상도,수,25398,30595,68966,124959,41653.0
상도,월,24156,28375,63752,116283,38761.0
상도,일,9030,20350,27451,56831,18944.0
상도,토,12646,28226,32959,73831,24610.0
상도,화,25579,29533,68661,123773,41258.0
상동,금,35096,39084,71329,145509,48503.0
상동,목,35493,36005,68496,139994,46665.0
상동,수,40982,41502,78822,161306,53769.0
상동,월,37940,37612,71993,147545,49182.0
상동,일,12504,31696,24694,68894,22965.0
상동,토,22718,47493,34615,104826,34942.0
상동,화,40210,39911,76981,157102,52367.0
상봉(시외버스터미널),금,36930,43783,100642,181355,60452.0
상봉(시외버스터미널),목,37259,40511,94912,172682,57561.0
상봉(시외버스터미널),수,42335,46529,109416,198280,66093.0
상봉(시외버스터미널),월,40378,44273,101708,186359,62120.0
상봉(시외버스터미널),일,13461,36583,44078,94122,31374.0
상봉(시외버스터미널),토,24037,55042,59239,138318,46106.0
상봉(시외버스터미널),화,42339,44724,109621,196684,65561.0
상수,금,27243,31976,39590,98809,32936.0
상수,목,27516,28664,32210,88390,29463.0
상수,수,31479,31837,36259,99575,33192.0
상수,월,29643,28324,30853,88820,29607.0
상수,일,6819,34035,21927,62781,20927.0
상수,토,10170,46489,31319,87978,29326.0
상수,화,31776,30421,34801,96998,32333.0
상왕십리,금,36094,36640,77133,149867,49956.0
상왕십리,목,35963,34441,76448,146852,48951.0
상왕십리,수,41837,39510,87872,169219,56406.0
상왕십리,월,40502,38118,81149,159769,53256.0
상왕십리,일,10957,26287,34391,71635,23878.0
상왕십리,토,18303,36051,42863,97217,32406.0
상왕십리,화,41961,38612,87995,168568,56189.0
상월곡(한국과학기술연구원),금,11835,14504,34210,60549,20183.0
상월곡(한국과학기술연구원),목,12138,13936,33999,60073,20024.0
상월곡(한국과학기술연구원),수,13726,15943,38964,68633,22878.0
상월곡(한국과학기술연구원),월,12981,15307,36989,65277,21759.0
상월곡(한국과학기술연구원),일,3773,11132,15668,30573,10191.0
상월곡(한국과학기술연구원),토,5391,13854,19978,39223,13074.0
상월곡(한국과학기술연구원),화,13748,15846,39451,69045,23015.0
상일동,금,24940,36863,110538,172341,57447.0
상일동,목,25341,35235,112174,172750,57583.0
상일동,수,28235,39493,127333,195061,65020.0
상일동,월,26588,36969,119146,182703,60901.0
상일동,일,9654,25555,38764,73973,24658.0
상일동,토,15243,36873,50931,103047,34349.0
상일동,화,27979,38765,128703,195447,65149.0
새절(신사),금,17218,33182,83117,133517,44506.0
새절(신사),목,17568,30993,81858,130419,43473.0
새절(신사),수,19812,36361,95383,151556,50519.0
새절(신사),월,18423,34086,88695,141204,47068.0
새절(신사),일,8554,24840,34379,67773,22591.0
새절(신사),토,12433,33869,45646,91948,30649.0
새절(신사),화,19655,34641,95561,149857,49952.0
서대문,금,133586,35996,36703,206285,68762.0
서대문,목,140134,36102,34789,211025,70342.0
서대문,수,163170,39925,40109,243204,81068.0
서대문,월,152741,37813,35834,226388,75463.0
서대문,일,13289,20125,15368,48782,16261.0
서대문,토,22717,28258,19695,70670,23557.0
서대문,화,164748,40804,39233,244785,81595.0
서울대입구(관악구청),금,85244,131326,298139,514709,171570.0
서울대입구(관악구청),목,84668,118131,285501,488300,162767.0
서울대입구(관악구청),수,97996,137830,331128,566954,188985.0
서울대입구(관악구청),월,93819,131433,303265,528517,176172.0
서울대입구(관악구청),일,40976,113417,144443,298836,99612.0
서울대입구(관악구청),토,58702,156709,179193,394604,131535.0
서울대입구(관악구청),화,97890,133141,326477,557508,185836.0
서울역,금,275978,171764,177112,624854,208285.0
서울역,목,286663,148375,132358,567396,189132.0
서울역,수,325726,160443,148623,634792,211597.0
서울역,월,312120,150462,132050,594632,198211.0
서울역,일,57909,126607,106419,290935,96978.0
서울역,토,101999,165188,108733,375920,125307.0
서울역,화,327961,154506,140639,623106,207702.0
서초,금,133915,50819,37723,222457,74152.0
서초,목,140594,50314,35932,226840,75613.0
서초,수,163508,57228,42534,263270,87757.0
서초,월,151034,51545,36166,238745,79582.0
서초,일,29381,40513,16491,86385,28795.0
서초,토,33275,37689,21349,92313,30771.0
서초,화,166451,57382,39564,263397,87799.0
석계,금,18016,34973,86014,139003,46334.0
석계,목,18580,33013,84708,136301,45434.0
석계,수,20845,39271,97480,157596,52532.0
석계,월,19174,36472,91104,146750,48917.0
석계,일,8694,25846,35536,70076,23359.0
석계,토,12536,34234,47392,94162,31387.0
석계,화,21074,37678,97956,156708,52236.0
석촌,금,25867,29166,44620,99653,33218.0
석촌,목,26382,27289,42180,95851,31950.0
석촌,수,29797,31645,49147,110589,36863.0
석촌,월,28121,29548,43769,101438,33813.0
석촌,일,7879,24665,21497,54041,18014.0
석촌,토,13810,34659,26928,75397,25132.0
석촌,화,30179,30587,47753,108519,36173.0
선릉,금,324604,133177,84894,542675,180892.0
선릉,목,336301,131461,77754,545516,181839.0
선릉,수,389873,150332,89807,630012,210004.0
선릉,월,373589,138297,77043,588929,196310.0
선릉,일,31631,51782,35101,118514,39505.0
선릉,토,71326,102142,46705,220173,73391.0
선릉,화,396274,149615,86921,632810,210937.0
성수,금,251051,87057,80329,418437,139479.0
성수,목,261465,82572,70986,415023,138341.0
성수,수,303974,93913,82091,479978,159993.0
성수,월,285291,82850,70897,439038,146346.0
성수,일,24477,73989,38253,136719,45573.0
성수,토,46613,99104,50963,196680,65560.0
성수,화,306252,89666,79009,474927,158309.0
성신여대입구(돈암),금,41344,62449,109460,213253,71084.0
성신여대입구(돈암),목,42196,58293,100546,201035,67012.0
성신여대입구(돈암),수,48266,67229,116110,231605,77202.0
성신여대입구(돈암),월,45885,63405,106396,215686,71895.0
성신여대입구(돈암),일,15397,54400,57189,126986,42329.0
성신여대입구(돈암),토,25269,73093,70297,168659,56220.0
성신여대입구(돈암),화,48832,66059,115426,230317,76772.0
송정,금,15966,20385,34017,70368,23456.0
송정,목,16223,19310,32159,67692,22564.0
송정,수,18093,22358,37623,78074,26025.0
송정,월,17524,21805,34530,73859,24620.0
송정,일,6616,14880,17785,39281,13094.0
송정,토,10333,20594,22222,53149,17716.0
송정,화,18577,21895,36853,77325,25775.0
송파,금,20423,22801,44681,87905,29302.0
송파,목,20732,21648,45077,87457,29152.0
송파,수,23355,24729,51749,99833,33278.0
송파,월,22186,22505,47717,92408,30803.0
송파,일,6273,15358,18831,40462,13487.0
송파,토,12068,22433,23957,58458,19486.0
송파,화,23572,23851,51622,99045,33015.0
수락산,금,22655,35183,80740,138578,46193.0
수락산,목,22703,33516,79860,136079,45360.0
수락산,수,25716,38974,92212,156902,52301.0
수락산,월,23767,36304,86011,146082,48694.0
수락산,일,24675,31872,32740,89287,29762.0
수락산,토,23438,40987,45109,109534,36511.0
수락산,화,25215,37094,92378,154687,51562.0
수서,금,61906,50738,83954,196598,65533.0
수서,목,63944,45534,71921,181399,60466.0
수서,수,71778,50452,81818,204048,68016.0
수서,월,69160,47462,74881,191503,63834.0
수서,일,18738,37284,42503,98525,32842.0
수서,토,31303,51845,45089,128237,42746.0
수서,화,71614,49467,79706,200787,66929.0
수유(강북구청),금,65216,98930,217894,382040,127347.0
수유(강북구청),목,64520,92266,205381,362167,120722.0
수유(강북구청),수,74503,106964,236398,417865,139288.0
수유(강북구청),월,71941,102995,220875,395811,131937.0
수유(강북구청),일,24770,76427,102919,204116,68039.0
수유(강북구청),토,37967,107047,137226,282240,94080.0
수유(강북구청),화,75300,104649,235994,415943,138648.0
수진,금,10366,15775,27118,53259,17753.0
수진,목,10873,15849,26951,53673,17891.0
수진,수,11604,17153,30511,59268,19756.0
수진,월,11902,16878,28164,56944,18981.0
수진,일,3976,11397,14217,29590,9863.0
수진,토,6827,17145,17654,41626,13875.0
수진,화,11635,16175,30280,58090,19363.0
숙대입구(갈월),금,51449,36117,50289,137855,45952.0
숙대입구(갈월),목,54258,33928,46125,134311,44770.0
숙대입구(갈월),수,61887,38421,53740,154048,51349.0
숙대입구(갈월),월,57781,36568,46889,141238,47079.0
숙대입구(갈월),일,10724,29016,25374,65114,21705.0
숙대입구(갈월),토,17017,39485,32597,89099,29700.0
숙대입구(갈월),화,62388,37550,52831,152769,50923.0
숭실대입구(살피재),금,24600,36255,74500,135355,45118.0
숭실대입구(살피재),목,23538,33818,73482,130838,43613.0
숭실대입구(살피재),수,26851,38902,86603,152356,50785.0
숭실대입구(살피재),월,25845,36775,78850,141470,47157.0
숭실대입구(살피재),일,7910,23294,33383,64587,21529.0
숭실대입구(살피재),토,12111,32870,41042,86023,28674.0
숭실대입구(살피재),화,27317,37970,84965,150252,50084.0
시청,금,327902,93208,45206,466316,155439.0
시청,목,341953,90091,38038,470082,156694.0
시청,수,399709,101948,45147,546804,182268.0
시청,월,371492,88232,35588,495312,165104.0
시청,일,35469,57413,20082,112964,37655.0
시청,토,55397,84498,26881,166776,55592.0
시청,화,402187,99401,42532,544120,181373.0
신금호,금,14126,18005,37663,69794,23265.0
신금호,목,14518,17283,38308,70109,23370.0
신금호,수,16662,20100,44671,81433,27144.0
신금호,월,15413,18656,40808,74877,24959.0
신금호,일,5409,11900,15806,33115,11038.0
신금호,토,8099,16695,20199,44993,14998.0
신금호,화,16604,20052,44667,81323,27108.0
신길,금,13709,8775,26847,49331,16444.0
신길,목,14368,7712,27258,49338,16446.0
신길,수,16665,9178,31182,57025,19008.0
신길,월,16003,8547,29075,53625,17875.0
신길,일,3087,7450,11847,22384,7461.0
신길,토,4815,10739,13678,29232,9744.0
신길,화,16904,8684,31424,57012,19004.0
신내,금,0,0,0,0,0.0
신내,목,0,0,0,0,0.0
신내,수,0,0,0,0,0.0
신내,토,0,0,0,0,0.0
신내,화,0,0,0,0,0.0
신답,금,2452,4543,13317,20312,6771.0
신답,목,2430,4314,13637,20381,6794.0
신답,수,2758,5220,15892,23870,7957.0
신답,월,2644,4605,14804,22053,7351.0
신답,일,1009,3134,4421,8564,2855.0
신답,토,1519,4387,5813,11719,3906.0
신답,화,2737,4800,16183,23720,7907.0
신당,금,81870,66433,100307,248610,82870.0
신당,목,82514,62857,94863,240234,80078.0
신당,수,94429,72082,110470,276981,92327.0
신당,월,90738,67811,100258,258807,86269.0
신당,일,24180,59560,55563,139303,46434.0
신당,토,42074,72673,56516,171263,57088.0
신당,화,95793,71124,109284,276201,92067.0
신대방,금,39852,65750,178273,283875,94625.0
신대방,목,40893,61644,172568,275105,91702.0
신대방,수,45899,72067,200144,318110,106037.0
신대방,월,43669,68223,186398,298290,99430.0
신대방,일,19066,53041,86861,158968,52989.0
신대방,토,25018,71216,111633,207867,69289.0
신대방,화,46038,69978,199586,315602,105201.0
신대방삼거리,금,34867,40663,100122,175652,58551.0
신대방삼거리,목,35465,38549,97840,171854,57285.0
신대방삼거리,수,40709,44485,113760,198954,66318.0
신대방삼거리,월,39173,41778,105391,186342,62114.0
신대방삼거리,일,11833,29924,42034,83791,27930.0
신대방삼거리,토,19796,43280,53540,116616,38872.0
신대방삼거리,화,41432,43276,113375,198083,66028.0
신도림,금,124618,136466,272269,533353,177784.0
신도림,목,125816,128656,254342,508814,169605.0
신도림,수,144751,145181,289505,579437,193146.0
신도림,월,139498,136799,260474,536771,178924.0
신도림,일,46754,128637,117579,292970,97657.0
신도림,토,69308,191675,161747,422730,140910.0
신도림,화,142011,138786,282725,563522,187841.0
신림,금,83647,155160,447819,686626,228875.0
신림,목,83610,142914,426507,653031,217677.0
신림,수,94666,165571,494897,755134,251711.0
신림,월,90095,158166,459915,708176,236059.0
신림,일,41387,135659,215365,392411,130804.0
신림,토,59801,188065,273746,521612,173871.0
신림,화,95128,160556,492776,748460,249487.0
신사,금,166911,114979,88570,370460,123487.0
신사,목,170554,106160,70179,346893,115631.0
신사,수,196340,118399,80518,395257,131752.0
신사,월,189256,111048,67447,367751,122584.0
신사,일,25977,86453,38242,150672,50224.0
신사,토,71927,150625,55627,278179,92726.0
신사,화,201641,118744,77348,397733,132578.0
신설동,금,79943,53754,54090,187787,62596.0
신설동,목,82111,51403,50009,183523,61174.0
신설동,수,94811,58920,58355,212086,70695.0
신설동,월,90375,55431,54077,199883,66628.0
신설동,일,20962,60199,29769,110930,36977.0
신설동,토,32043,63960,35778,131781,43927.0
신설동,화,94230,55918,57338,207486,69162.0
신용산,금,90968,43406,43977,178351,59450.0
신용산,목,97766,40161,36829,174756,58252.0
신용산,수,111457,44192,43365,199014,66338.0
신용산,월,106558,41697,37164,185419,61806.0
신용산,일,14770,35954,21381,72105,24035.0
신용산,토,25121,49342,25020,99483,33161.0
신용산,화,112924,42598,40926,196448,65483.0
신정(은행정),금,16028,28511,78651,123190,41063.0
신정(은행정),목,16072,27176,79082,122330,40777.0
신정(은행정),수,18405,31696,92101,142202,47401.0
신정(은행정),월,17415,28760,85681,131856,43952.0
신정(은행정),일,7060,19956,33282,60298,20099.0
신정(은행정),토,10866,28885,43272,83023,27674.0
신정(은행정),화,18388,30198,91998,140584,46861.0
신정네거리,금,15611,28985,73152,117748,39249.0
신정네거리,목,15235,26823,71107,113165,37722.0
신정네거리,수,17082,31823,83157,132062,44021.0
신정네거리,월,16718,29056,77117,122891,40964.0
신정네거리,일,7137,19475,27147,53759,17920.0
신정네거리,토,12024,29049,36516,77589,25863.0
신정네거리,화,17422,30495,83279,131196,43732.0
신중동,금,47107,36206,75748,159061,53020.0
신중동,목,47852,32935,71898,152685,50895.0
신중동,수,54971,38987,83883,177841,59280.0
신중동,월,51895,36084,77006,164985,54995.0
신중동,일,12884,28250,28601,69735,23245.0
신중동,토,21393,40770,39613,101776,33925.0
신중동,화,54818,37252,82975,175045,58348.0
신촌,금,104837,119950,136529,361316,120439.0
신촌,목,107008,110830,118267,336105,112035.0
신촌,수,122400,126165,138768,387333,129111.0
신촌,월,115696,119825,123424,358945,119648.0
신촌,일,35867,107936,74294,218097,72699.0
신촌,토,61287,149906,96196,307389,102463.0
신촌,화,122666,122182,133963,378811,126270.0
신풍,금,24620,30035,72254,126909,42303.0
신풍,목,25134,29081,70515,124730,41577.0
신풍,수,28451,33388,82161,144000,48000.0
신풍,월,26793,31245,76448,134486,44829.0
신풍,일,10688,22846,28855,62389,20796.0
신풍,토,15446,32034,39590,87070,29023.0
신풍,화,28646,32439,81957,143042,47681.0
신흥,금,10452,16765,28722,55939,18646.0
신흥,목,10874,16594,27116,54584,18195.0
신흥,수,11676,17674,31005,60355,20118.0
신흥,월,11094,17346,28914,57354,19118.0
신흥,일,4181,13197,15155,32533,10844.0
신흥,토,7373,18119,18836,44328,14776.0
신흥,화,11535,16818,30508,58861,19620.0
쌍문,금,37067,72086,192899,302052,100684.0
쌍문,목,38129,67990,190009,296128,98709.0
쌍문,수,41671,79080,218766,339517,113172.0
쌍문,월,39195,74722,205681,319598,106533.0
쌍문,일,18430,52148,81991,152569,50856.0
쌍문,토,27154,75310,109416,211880,70627.0
쌍문,화,41973,77562,220652,340187,113396.0
아차산(어린이대공원후문),금,28946,44128,83284,156358,52119.0
아차산(어린이대공원후문),목,29213,41221,81843,152277,50759.0
아차산(어린이대공원후문),수,32869,47982,94904,175755,58585.0
아차산(어린이대공원후문),월,30144,43302,87842,161288,53763.0
아차산(어린이대공원후문),일,24150,47540,37543,109233,36411.0
아차산(어린이대공원후문),토,26138,56483,49178,131799,43933.0
아차산(어린이대공원후문),화,32450,45030,95518,172998,57666.0
아현,금,24798,28910,55495,109203,36401.0
아현,목,25327,27099,54088,106514,35505.0
아현,수,29224,31857,62111,123192,41064.0
아현,월,26268,29878,58044,114190,38063.0
아현,일,8032,20348,26551,54931,18310.0
아현,토,14765,28774,33249,76788,25596.0
아현,화,28981,31206,62361,122548,40849.0
안국,금,123680,59873,26120,209673,69891.0
안국,목,128905,54999,21926,205830,68610.0
안국,수,147941,64038,25722,237701,79234.0
안국,월,135381,49745,20858,205984,68661.0
안국,일,21660,65371,13780,100811,33604.0
안국,토,32815,89529,19812,142156,47385.0
안국,화,151503,58696,24574,234773,78258.0
안암(고대병원앞),금,43387,32694,32854,108935,36312.0
안암(고대병원앞),목,47128,31245,28108,106481,35494.0
안암(고대병원앞),수,53399,34677,32457,120533,40178.0
안암(고대병원앞),월,50854,34376,29548,114778,38259.0
안암(고대병원앞),일,6844,22782,25189,54815,18272.0
안암(고대병원앞),토,12760,27163,26646,66569,22190.0
안암(고대병원앞),화,54233,35618,31800,121651,40550.0
암사,금,24406,45552,118041,187999,62666.0
암사,목,24496,43025,117579,185100,61700.0
암사,수,27258,50009,135554,212821,70940.0
암사,월,26372,46252,127215,199839,66613.0
암사,일,11180,32934,46958,91072,30357.0
암사,토,18303,47756,60929,126988,42329.0
암사,화,27374,48116,136672,212162,70721.0
압구정,금,185838,117682,79012,382532,127511.0
압구정,목,185609,108546,68522,362677,120892.0
압구정,수,214391,122282,81456,418129,139376.0
압구정,월,206546,113043,66984,386573,128858.0
압구정,일,47631,68559,31658,147848,49283.0
압구정,토,103873,129073,42613,275559,91853.0
압구정,화,220543,123031,77300,420874,140291.0
애오개,금,26864,17771,31587,76222,25407.0
애오개,목,27567,16840,31646,76053,25351.0
애오개,수,31816,19640,36333,87789,29263.0
애오개,월,28941,17768,33448,80157,26719.0
애오개,일,5655,10774,13040,29469,9823.0
애오개,토,8258,14541,15972,38771,12924.0
애오개,화,31967,19218,36586,87771,29257.0
약수,금,53423,49544,77021,179988,59996.0
약수,목,53484,47078,72768,173330,57777.0
약수,수,62085,53996,84748,200829,66943.0
약수,월,59038,51262,76196,186496,62165.0
약수,일,13789,34680,36251,84720,28240.0
약수,토,24199,48272,47252,119723,39908.0
약수,화,62474,53248,82725,198447,66149.0
양재(서초구청),금,246319,93744,114238,454301,151434.0
양재(서초구청),목,257887,89278,104223,451388,150463.0
양재(서초구청),수,294604,100726,123119,518449,172816.0
양재(서초구청),월,279467,91755,109037,480259,160086.0
양재(서초구청),일,38234,59962,53746,151942,50647.0
양재(서초구청),토,63603,92689,62527,218819,72940.0
양재(서초구청),화,297900,100854,118850,517604,172535.0
양천구청,금,11328,18247,49942,79517,26506.0
양천구청,목,11641,16872,50040,78553,26184.0
양천구청,수,13068,19951,58575,91594,30531.0
양천구청,월,12527,18493,54131,85151,28384.0
양천구청,일,4500,11876,18800,35176,11725.0
양천구청,토,7189,17095,24162,48446,16149.0
양천구청,화,13120,19265,58124,90509,30170.0
양평,금,34241,14964,33911,83116,27705.0
양평,목,35307,14390,34671,84368,28123.0
양평,수,40534,17170,39676,97380,32460.0
양평,월,38655,15368,36978,91001,30334.0
양평,일,4792,10290,13682,28764,9588.0
양평,토,7551,14995,16382,38928,12976.0
양평,화,41142,16211,39984,97337,32446.0
어린이대공원(세종대),금,48035,35396,49380,132811,44270.0
어린이대공원(세종대),목,50062,32425,45607,128094,42698.0
어린이대공원(세종대),수,57407,37624,53230,148261,49420.0
어린이대공원(세종대),월,54209,35160,48755,138124,46041.0
어린이대공원(세종대),일,13349,31992,29248,74589,24863.0
어린이대공원(세종대),토,17791,38744,32857,89392,29797.0
어린이대공원(세종대),화,57893,36936,52614,147443,49148.0
여의나루,금,63546,36608,28802,128956,42985.0
여의나루,목,65499,26988,19785,112272,37424.0
여의나루,수,77128,33952,25437,136517,45506.0
여의나루,월,71489,28779,18662,118930,39643.0
여의나루,일,19225,55936,20390,95551,31850.0
여의나루,토,22531,56708,22305,101544,33848.0
여의나루,화,76334,28607,21426,126367,42122.0
여의도,금,221600,55406,44950,321956,107319.0
여의도,목,230721,51128,39202,321051,107017.0
여의도,수,267278,58388,45371,371037,123679.0
여의도,월,250727,53435,37681,341843,113948.0
여의도,일,20129,43992,16437,80558,26853.0
여의도,토,31694,60844,22896,115434,38478.0
여의도,화,269774,56335,43318,369427,123142.0
역삼,금,384936,124288,82994,592218,197406.0
역삼,목,400629,122366,74943,597938,199313.0
역삼,수,466795,139411,86689,692895,230965.0
역삼,월,442883,126687,73976,643546,214515.0
역삼,일,37374,60607,34472,132453,44151.0
역삼,토,70333,99811,46908,217052,72351.0
역삼,화,474619,139275,82310,696204,232068.0
역촌,금,8898,11961,27474,48333,16111.0
역촌,목,8694,11175,27111,46980,15660.0
역촌,수,10234,12987,31343,54564,18188.0
역촌,월,9618,12347,29254,51219,17073.0
역촌,일,3287,8613,11832,23732,7911.0
역촌,토,4736,11902,15641,32279,10760.0
역촌,화,9922,12580,31313,53815,17938.0
연신내,금,49787,108033,237811,395631,131877.0
연신내,목,49144,98987,229055,377186,125729.0
연신내,수,56477,115760,263800,436037,145346.0
연신내,월,53345,110504,245245,409094,136365.0
연신내,일,31167,86182,105003,222352,74117.0
연신내,토,43857,121372,140685,305914,101971.0
연신내,화,56126,112246,263398,431770,143923.0
영등포구청,금,137326,69573,99059,305958,101986.0
영등포구청,목,142663,68507,95440,306610,102203.0
영등포구청,수,164146,77539,109648,351333,117111.0
영등포구청,월,157072,73741,99558,330371,110124.0
영등포구청,일,19866,43808,40026,103700,34567.0
영등포구청,토,36068,70163,53174,159405,53135.0
영등포구청,화,166391,76745,109011,352147,117382.0
영등포시장,금,38999,29815,40933,109747,36582.0
영등포시장,목,40443,27529,39179,107151,35717.0
영등포시장,수,46131,31766,45966,123863,41288.0
영등포시장,월,44228,30677,41687,116592,38864.0
영등포시장,일,9604,23113,17235,49952,16651.0
영등포시장,토,18337,37333,22193,77863,25954.0
영등포시장,화,46512,31392,45363,123267,41089.0
오금,금,30967,22399,48915,102281,34094.0
오금,목,31549,21287,49076,101912,33971.0
오금,수,35821,23895,55928,115644,38548.0
오금,월,33895,22662,51516,108073,36024.0
오금,일,7197,16523,19839,43559,14520.0
오금,토,12490,20943,25686,59119,19706.0
오금,화,36370,23851,56019,116240,38747.0
오목교(목동운동장앞),금,84200,74789,112251,271240,90413.0
오목교(목동운동장앞),목,84762,69293,105344,259399,86466.0
오목교(목동운동장앞),수,96962,80769,122921,300652,100217.0
오목교(목동운동장앞),월,92031,72600,111247,275878,91959.0
오목교(목동운동장앞),일,29136,56482,42858,128476,42825.0
오목교(목동운동장앞),토,47195,80799,55358,183352,61117.0
오목교(목동운동장앞),화,98216,77593,120854,296663,98888.0
옥수,금,20925,29451,57000,107376,35792.0
옥수,목,20860,28263,55469,104592,34864.0
옥수,수,23862,32462,64748,121072,40357.0
옥수,월,22528,29974,57890,110392,36797.0
옥수,일,8531,24253,26372,59156,19719.0
옥수,토,13260,31803,32670,77733,25911.0
옥수,화,23741,31857,63038,118636,39545.0
온수(성공회대입구),금,18065,21031,69032,108128,36043.0
온수(성공회대입구),목,18262,20044,69607,107913,35971.0
온수(성공회대입구),수,21437,23223,80692,125352,41784.0
온수(성공회대입구),월,19484,21390,75618,116492,38831.0
온수(성공회대입구),일,6125,14729,21670,42524,14175.0
온수(성공회대입구),토,8785,21763,31083,61631,20544.0
온수(성공회대입구),화,21519,22591,80739,124849,41616.0
올림픽공원(한국체대),금,11860,11466,16097,39423,13141.0
올림픽공원(한국체대),목,11950,11127,15874,38951,12984.0
올림픽공원(한국체대),수,13570,12728,18520,44818,14939.0
올림픽공원(한국체대),월,13321,11617,16919,41857,13952.0
올림픽공원(한국체대),일,3635,8703,6860,19198,6399.0
올림픽공원(한국체대),토,6781,11301,8896,26978,8993.0
올림픽공원(한국체대),화,13738,12068,18298,44104,14701.0
왕십리(성동구청),금,49486,57994,99150,206630,68877.0
왕십리(성동구청),목,50546,53709,87955,192210,64070.0
왕십리(성동구청),수,58097,61348,101953,221398,73799.0
왕십리(성동구청),월,54656,57510,90207,202373,67458.0
왕십리(성동구청),일,14581,51065,50799,116445,38815.0
왕십리(성동구청),토,26104,72790,65285,164179,54726.0
왕십리(성동구청),화,57899,59499,98149,215547,71849.0
용답,금,4665,9124,17107,30896,10299.0
용답,목,4863,8531,16319,29713,9904.0
용답,수,5498,9948,18770,34216,11405.0
용답,월,5203,9596,17647,32446,10815.0
용답,일,1984,7070,9718,18772,6257.0
용답,토,2704,8708,10968,22380,7460.0
용답,화,5448,9754,18507,33709,11236.0
용두(동대문구청),금,7121,9355,11541,28017,9339.0
용두(동대문구청),목,7165,8634,11281,27080,9027.0
용두(동대문구청),수,8273,10623,12948,31844,10615.0
용두(동대문구청),월,7825,9942,11943,29710,9903.0
용두(동대문구청),일,2018,5835,5068,12921,4307.0
용두(동대문구청),토,3802,8872,6510,19184,6395.0
용두(동대문구청),화,8297,9847,12805,30949,10316.0
용마산(용마폭포공원),금,10347,15558,39697,65602,21867.0
용마산(용마폭포공원),목,10462,14322,39138,63922,21307.0
용마산(용마폭포공원),수,11931,16605,44778,73314,24438.0
용마산(용마폭포공원),월,10973,15020,41986,67979,22660.0
용마산(용마폭포공원),일,7526,13988,17612,39126,13042.0
용마산(용마폭포공원),토,9627,17604,22443,49674,16558.0
용마산(용마폭포공원),화,11746,16015,45001,72762,24254.0
우장산,금,25456,42651,85452,153559,51186.0
우장산,목,25558,40687,84874,151119,50373.0
우장산,수,29821,47127,98580,175528,58509.0
우장산,월,27549,43864,91671,163084,54361.0
우장산,일,9017,26784,34540,70341,23447.0
우장산,토,17112,40421,44771,102304,34101.0
우장산,화,29386,46155,98174,173715,57905.0
월곡(동덕여대),금,25864,32373,65437,123674,41225.0
월곡(동덕여대),목,26436,30147,63941,120524,40175.0
월곡(동덕여대),수,29640,35146,73687,138473,46158.0
월곡(동덕여대),월,28725,33100,69373,131198,43733.0
월곡(동덕여대),일,7378,21810,28182,57370,19123.0
월곡(동덕여대),토,11932,31541,36617,80090,26697.0
월곡(동덕여대),화,30081,33717,74018,137816,45939.0
월드컵경기장(성산),금,11960,22146,18105,52211,17404.0
월드컵경기장(성산),목,12970,20883,17167,51020,17007.0
월드컵경기장(성산),수,14035,24252,21480,59767,19922.0
월드컵경기장(성산),월,12774,21079,18205,52058,17353.0
월드컵경기장(성산),일,6824,24127,7626,38577,12859.0
월드컵경기장(성산),토,9316,27529,10970,47815,15938.0
월드컵경기장(성산),화,13717,21712,19711,55140,18380.0
을지로3가,금,219743,73909,50680,344332,114777.0
을지로3가,목,230671,70864,38524,340059,113353.0
을지로3가,수,269345,80689,44114,394148,131383.0
을지로3가,월,252942,73654,34727,361323,120441.0
을지로3가,일,22733,47694,20934,91361,30454.0
을지로3가,토,41095,74345,34911,150351,50117.0
을지로3가,화,270144,79750,40482,390376,130125.0
을지로4가,금,125364,56823,22827,205014,68338.0
을지로4가,목,129114,56301,19094,204509,68170.0
을지로4가,수,149891,65944,22156,237991,79330.0
을지로4가,월,142889,62256,18508,223653,74551.0
을지로4가,일,11717,26645,9446,47808,15936.0
을지로4가,토,42931,58189,14645,115765,38588.0
을지로4가,화,152165,65627,20948,238740,79580.0
을지로입구,금,272673,90102,55805,418580,139527.0
을지로입구,목,287313,83335,45076,415724,138575.0
을지로입구,수,334534,96564,53426,484524,161508.0
을지로입구,월,310967,85215,44793,440975,146992.0
을지로입구,일,50837,73453,28483,152773,50924.0
을지로입구,토,68812,102079,39710,210601,70200.0
을지로입구,화,338075,92720,49923,480718,160239.0
응암,금,23133,47457,123562,194152,64717.0
응암,목,22820,44185,122116,189121,63040.0
응암,수,25775,52836,141556,220167,73389.0
응암,월,24383,48961,132500,205844,68615.0
응암,일,11731,36153,51707,99591,33197.0
응암,토,17074,50550,68794,136418,45473.0
응암,화,25489,50498,141057,217044,72348.0
이대,금,41530,43686,50893,136109,45370.0
이대,목,41612,39368,47281,128261,42754.0
이대,수,49032,45698,55681,150411,50137.0
이대,월,47230,44570,49937,141737,47246.0
이대,일,11144,30778,29209,71131,23710.0
이대,토,21825,45482,34185,101492,33831.0
이대,화,49889,45293,54233,149415,49805.0
이수,금,48276,45992,76506,170774,56925.0
이수,목,49215,42975,71512,163702,54567.0
이수,수,56871,49474,83829,190174,63391.0
이수,월,53962,46459,73484,173905,57968.0
이수,일,13795,35945,32742,82482,27494.0
이수,토,24835,54507,43099,122441,40814.0
이수,화,56724,47431,81189,185344,61781.0
이촌(국립중앙박물관),금,29410,24746,32352,86508,28836.0
이촌(국립중앙박물관),목,29836,23379,30971,84186,28062.0
이촌(국립중앙박물관),수,33529,27306,37455,98290,32763.0
이촌(국립중앙박물관),월,31428,23849,31952,87229,29076.0
이촌(국립중앙박물관),일,12265,22596,14120,48981,16327.0
이촌(국립중앙박물관),토,16289,30187,17649,64125,21375.0
이촌(국립중앙박물관),화,34221,26071,35513,95805,31935.0
이태원,금,31666,35076,45536,112278,37426.0
이태원,목,32234,30266,34737,97237,32412.0
이태원,수,37583,32607,39649,109839,36613.0
이태원,월,35147,30645,33638,99430,33143.0
이태원,일,11206,44888,29054,85148,28383.0
이태원,토,15495,54812,43752,114059,38020.0
이태원,화,37247,30556,36610,104413,34804.0
일원,금,40384,28483,34095,102962,34321.0
일원,목,43458,31373,34544,109375,36458.0
일원,수,47878,33478,39307,120663,40221.0
일원,월,45553,32101,35989,113643,37881.0
일원,일,8533,14825,13856,37214,12405.0
일원,토,14844,18102,17132,50078,16693.0
일원,화,48217,34219,39203,121639,40546.0
잠실(송파구청),금,267321,257129,374955,899405,299802.0
잠실(송파구청),목,274261,228564,341028,843853,281284.0
잠실(송파구청),수,308569,262860,395978,967407,322469.0
잠실(송파구청),월,296446,238049,352688,887183,295728.0
잠실(송파구청),일,97423,272751,169296,539470,179823.0
잠실(송파구청),토,140418,373221,226543,740182,246727.0
잠실(송파구청),화,312445,245136,385081,942662,314221.0
잠실나루,금,46513,39898,62393,148804,49601.0
잠실나루,목,49641,40446,61807,151894,50631.0
잠실나루,수,56093,46916,71971,174980,58327.0
잠실나루,월,53726,42513,65421,161660,53887.0
잠실나루,일,9319,21169,23643,54131,18044.0
잠실나루,토,15924,29256,29213,74393,24798.0
잠실나루,화,55969,46181,71587,173737,57912.0
잠실새내,금,42342,69136,122470,233948,77983.0
잠실새내,목,41220,63902,111833,216955,72318.0
잠실새내,수,46931,73464,131348,251743,83914.0
잠실새내,월,45981,68532,117427,231940,77313.0
잠실새내,일,14207,50383,51240,115830,38610.0
잠실새내,토,33969,76683,67853,178505,59502.0
잠실새내,화,47298,71232,128001,246531,82177.0
잠원,금,13647,14489,23944,52080,17360.0
잠원,목,13682,13578,23846,51106,17035.0
잠원,수,15659,15501,28079,59239,19746.0
잠원,월,15017,14536,24920,54473,18158.0
잠원,일,4695,9960,9792,24447,8149.0
잠원,토,9409,13997,12346,35752,11917.0
잠원,화,15479,14851,27571,57901,19300.0
장승배기,금,20277,27206,56720,104203,34734.0
장승배기,목,20490,26177,55741,102408,34136.0
장승배기,수,23442,30107,65097,118646,39549.0
장승배기,월,22451,28729,59923,111103,37034.0
장승배기,일,8605,19597,24395,52597,17532.0
장승배기,토,13742,27272,31765,72779,24260.0
장승배기,화,23728,29222,64735,117685,39228.0
장암,금,2561,2983,5080,10624,3541.0
장암,목,2596,2684,4561,9841,3280.0
장암,수,2943,2986,5230,11159,3720.0
장암,월,2502,2682,5046,10230,3410.0
장암,일,4605,3890,1432,9927,3309.0
장암,토,4211,4663,2319,11193,3731.0
장암,화,2883,2721,5295,10899,3633.0
장지,금,61291,49887,77260,188438,62813.0
장지,목,62160,47190,75541,184891,61630.0
장지,수,70114,53250,86656,210020,70007.0
장지,월,65075,50394,78294,193763,64588.0
장지,일,23534,43504,36251,103289,34430.0
장지,토,31890,54450,44810,131150,43717.0
장지,화,68949,51093,85448,205490,68497.0
장한평,금,67415,44116,94920,206451,68817.0
장한평,목,69519,41907,92284,203710,67903.0
장한평,수,80348,49110,107275,236733,78911.0
장한평,월,76044,45008,98901,219953,73318.0
장한평,일,12014,28439,36263,76716,25572.0
장한평,토,24820,42668,48024,115512,38504.0
장한평,화,80297,47074,107246,234617,78206.0
제기동,금,55749,93674,43517,192940,64313.0
제기동,목,57305,89574,41706,188585,62862.0
제기동,수,66553,110592,48496,225641,75214.0
제기동,월,65041,103939,44972,213952,71317.0
제기동,일,18209,70428,24607,113244,37748.0
제기동,토,38086,102882,29526,170494,56831.0
제기동,화,66889,105941,47500,220330,73443.0
종각,금,220267,86233,48295,354795,118265.0
종각,목,227297,80526,38649,346472,115491.0
종각,수,266767,92760,44028,403555,134518.0
종각,월,252291,84645,36231,373167,124389.0
종각,일,27769,61441,20049,109259,36420.0
종각,토,47018,90863,30531,168412,56137.0
종각,화,270183,88396,41780,400359,133453.0
종로3가,금,200917,205119,91644,497680,165893.0
종로3가,목,208933,190597,69029,468559,156186.0
종로3가,수,244205,223385,81704,549294,183098.0
종로3가,월,231835,209124,65904,506863,168954.0
종로3가,일,45097,164100,45170,254367,84789.0
종로3가,토,85797,243962,73228,402987,134329.0
종로3가,화,244799,214527,73420,532746,177582.0
종로5가,금,113410,91844,31580,236834,78945.0
종로5가,목,119258,87557,26117,232932,77644.0
종로5가,수,137983,103066,29371,270420,90140.0
종로5가,월,132936,97712,24979,255627,85209.0
종로5가,일,16478,56889,15106,88473,29491.0
종로5가,토,50221,109286,24342,183849,61283.0
종로5가,화,140402,100853,28270,269525,89842.0
종합운동장,금,22322,20429,38329,81080,27027.0
종합운동장,목,22759,19169,37814,79742,26581.0
종합운동장,수,27089,22621,43135,92845,30948.0
종합운동장,월,25832,20844,39253,85929,28643.0
종합운동장,일,8514,15168,16248,39930,13310.0
종합운동장,토,10794,20711,20083,51588,17196.0
종합운동장,화,27214,21400,43074,91688,30563.0
중계,금,24556,31991,83354,139901,46634.0
중계,목,24876,30699,83867,139442,46481.0
중계,수,28866,35905,96755,161526,53842.0
중계,월,26637,33444,91178,151259,50420.0
중계,일,8392,23372,34188,65952,21984.0
중계,토,13505,31765,44550,89820,29940.0
중계,화,28891,34955,97499,161345,53782.0
중곡,금,20563,26289,57429,104281,34760.0
중곡,목,21219,25029,55925,102173,34058.0
중곡,수,24273,29147,64708,118128,39376.0
중곡,월,23015,27286,59759,110060,36687.0
중곡,일,8312,18591,26056,52959,17653.0
중곡,토,11440,25857,33506,70803,23601.0
중곡,화,24219,28391,64318,116928,38976.0
중화,금,23255,28817,68296,120368,40123.0
중화,목,23273,27677,66434,117384,39128.0
중화,수,26902,32669,76747,136318,45439.0
중화,월,25393,30652,71819,127864,42621.0
중화,일,9151,21058,30527,60736,20245.0
중화,토,13348,29473,40129,82950,27650.0
중화,화,26987,32047,76994,136028,45343.0
증산(명지대앞),금,13311,27313,69728,110352,36784.0
증산(명지대앞),목,13177,25905,68342,107424,35808.0
증산(명지대앞),수,15064,30032,79783,124879,41626.0
증산(명지대앞),월,14396,28387,73824,116607,38869.0
증산(명지대앞),일,7222,22652,31120,60994,20331.0
증산(명지대앞),토,10097,30546,40613,81256,27085.0
증산(명지대앞),화,15070,29218,79078,123366,41122.0
지축,금,5466,9314,25540,40320,13440.0
지축,목,5571,8503,25823,39897,13299.0
지축,수,6402,10190,30486,47078,15693.0
지축,월,5837,9625,28170,43632,14544.0
지축,일,2420,6368,9384,18172,6057.0
지축,토,4465,9254,12062,25781,8594.0
지축,화,6343,9858,30106,46307,15436.0
창동,금,50019,92125,165061,307205,102402.0
창동,목,51026,86899,159181,297106,99035.0
창동,수,57141,101645,184968,343754,114585.0
창동,월,53612,93877,169951,317440,105813.0
창동,일,25520,72455,69779,167754,55918.0
창동,토,34791,97205,94505,226501,75500.0
창동,화,57179,98474,183556,339209,113070.0
창신,금,7483,7309,16695,31487,10496.0
창신,목,7511,7084,17140,31735,10578.0
창신,수,8513,8055,19942,36510,12170.0
창신,월,8066,7567,18449,34082,11361.0
창신,일,2653,5830,7600,16083,5361.0
창신,토,3735,7043,9280,20058,6686.0
창신,화,9176,7954,19995,37125,12375.0
천왕,금,16576,26732,74413,117721,39240.0
천왕,목,16485,24705,75060,116250,38750.0
천왕,수,18740,29782,86883,135405,45135.0
천왕,월,17342,26804,82109,126255,42085.0
천왕,일,8245,18012,24197,50454,16818.0
천왕,토,9981,25845,33281,69107,23036.0
천왕,화,18572,28019,87371,133962,44654.0
천호(풍납토성),금,88849,119594,194684,403127,134376.0
천호(풍납토성),목,90102,110629,176298,377029,125676.0
천호(풍납토성),수,102683,128120,203798,434601,144867.0
천호(풍납토성),월,97041,119068,185724,401833,133944.0
천호(풍납토성),일,37921,107728,88723,234372,78124.0
천호(풍납토성),토,60330,149421,118904,328655,109552.0
천호(풍납토성),화,103636,123205,200592,427433,142478.0
철산,금,44027,59107,143287,246421,82140.0
철산,목,44485,53581,137899,235965,78655.0
철산,수,50853,63519,160731,275103,91701.0
철산,월,48507,57267,148095,253869,84623.0
철산,일,17189,42486,49764,109439,36480.0
철산,토,29910,63356,68824,162090,54030.0
철산,화,50421,60172,159296,269889,89963.0
청구,금,35330,20404,30106,85840,28613.0
청구,목,36285,19737,28957,84979,28326.0
청구,수,42057,22554,33460,98071,32690.0
청구,월,40103,20971,30706,91780,30593.0
청구,일,5923,13997,15988,35908,11969.0
청구,토,13558,19589,19742,52889,17630.0
청구,화,42573,22208,33090,97871,32624.0
청담,금,161620,44688,32473,238781,79594.0
청담,목,164866,42944,29460,237270,79090.0
청담,수,191159,48442,34599,274200,91400.0
청담,월,178408,43614,29687,251709,83903.0
청담,일,29301,30085,16218,75604,25201.0
청담,토,58466,50202,20615,129283,43094.0
청담,화,193472,46626,33280,273378,91126.0
청량리(서울시립대입구),금,54713,97252,75871,227836,75945.0
청량리(서울시립대입구),목,55106,91198,71105,217409,72470.0
청량리(서울시립대입구),수,62562,109112,81564,253238,84413.0
청량리(서울시립대입구),월,61049,101118,75579,237746,79249.0
청량리(서울시립대입구),일,22390,79791,38861,141042,47014.0
청량리(서울시립대입구),토,44028,105551,49437,199016,66339.0
청량리(서울시립대입구),화,63847,104486,80488,248821,82940.0
총신대입구(이수),금,53209,68687,109215,231111,77037.0
총신대입구(이수),목,52904,64342,104541,221787,73929.0
총신대입구(이수),수,61905,75467,122844,260216,86739.0
총신대입구(이수),월,59173,69616,108682,237471,79157.0
총신대입구(이수),일,17400,52306,45308,115014,38338.0
총신대입구(이수),토,30208,74845,60040,165093,55031.0
총신대입구(이수),화,61623,72470,118821,252914,84305.0
춘의,금,52315,17484,35959,105758,35253.0
춘의,목,54498,16529,35044,106071,35357.0
춘의,수,62116,19459,40748,122323,40774.0
춘의,월,58172,18374,37537,114083,38028.0
춘의,일,6209,12330,15820,34359,11453.0
춘의,토,15960,17302,20893,54155,18052.0
춘의,화,62030,18881,40235,121146,40382.0
충무로,금,176302,71076,45924,293302,97767.0
충무로,목,181261,68194,39473,288928,96309.0
충무로,수,212284,78480,46638,337402,112467.0
충무로,월,200337,71320,40228,311885,103962.0
충무로,일,19143,39627,21418,80188,26729.0
충무로,토,43438,59413,28549,131400,43800.0
충무로,화,213818,76331,44593,334742,111581.0
충정로(경기대입구),금,82868,32803,50909,166580,55527.0
충정로(경기대입구),목,86310,31455,49382,167147,55716.0
충정로(경기대입구),수,100828,36243,57236,194307,64769.0
충정로(경기대입구),월,96343,33575,51803,181721,60574.0
충정로(경기대입구),일,11533,22384,23871,57788,19263.0
충정로(경기대입구),토,16373,33329,30785,80487,26829.0
충정로(경기대입구),화,102262,35885,56135,194282,64761.0
태릉입구,금,29994,38365,81067,149426,49809.0
태릉입구,목,30224,36560,77029,143813,47938.0
태릉입구,수,35056,42398,89472,166926,55642.0
태릉입구,월,33048,39628,82661,155337,51779.0
태릉입구,일,12218,29533,37638,79389,26463.0
태릉입구,토,19199,40386,48016,107601,35867.0
태릉입구,화,34841,40584,88723,164148,54716.0
하계,금,30653,45065,104845,180563,60188.0
하계,목,31809,44135,103566,179510,59837.0
하계,수,37912,54332,120621,212865,70955.0
하계,월,33330,46679,111971,191980,63993.0
하계,일,12544,34135,42780,89459,29820.0
하계,토,19403,47653,55266,122322,40774.0
하계,화,35030,49527,120089,204646,68215.0
하남검단산,금,6,29,1,36,12.0
하남검단산,수,1032,1789,2383,5204,1735.0
하남검단산,월,810,1826,2378,5014,1671.0
하남검단산,일,697,2601,1437,4735,1578.0
하남검단산,토,1569,3711,1961,7241,2414.0
하남검단산,화,940,1820,2363,5123,1708.0
하남시청(덕풍·신장),금,0,27,3,30,10.0
하남시청(덕풍·신장),수,819,1566,2681,5066,1689.0
하남시청(덕풍·신장),월,732,1675,2751,5158,1719.0
하남시청(덕풍·신장),일,360,1452,1445,3257,1086.0
하남시청(덕풍·신장),토,696,2233,1824,4753,1584.0
하남시청(덕풍·신장),화,796,1513,2715,5024,1675.0
하남풍산,금,13956,13947,30383,58286,19429.0
하남풍산,목,14750,12743,29806,57299,19100.0
하남풍산,수,15530,13655,33142,62327,20776.0
하남풍산,월,14908,12810,30110,57828,19276.0
하남풍산,일,6650,12377,11843,30870,10290.0
하남풍산,토,8634,16374,15547,40555,13518.0
하남풍산,화,15522,13550,33023,62095,20698.0
학동,금,203014,47439,30477,280930,93643.0
학동,목,209318,46267,27693,283278,94426.0
학동,수,244712,52488,32421,329621,109874.0
학동,월,228765,47845,27977,304587,101529.0
학동,일,21517,29213,14551,65281,21760.0
학동,토,48507,51112,18669,118288,39429.0
학동,화,246587,52205,31731,330523,110174.0
학여울,금,9204,7446,7518,24168,8056.0
학여울,목,8310,5498,7297,21105,7035.0
학여울,수,8989,5635,8542,23166,7722.0
학여울,월,8461,4905,7613,20979,6993.0
학여울,일,3343,5188,3196,11727,3909.0
학여울,토,4841,7552,3753,16146,5382.0
학여울,화,9109,5375,8295,22779,7593.0
한강진,금,44703,28218,25761,98682,32894.0
한강진,목,46541,25143,20418,92102,30701.0
한강진,수,53453,29801,22826,106080,35360.0
한강진,월,49376,23702,15838,88916,29639.0
한강진,일,11275,41979,14470,67724,22575.0
한강진,토,15922,52534,19890,88346,29449.0
한강진,화,53878,26224,21398,101500,33833.0
한성대입구(삼선교),금,36291,40865,67524,144680,48227.0
한성대입구(삼선교),목,37409,38145,64308,139862,46621.0
한성대입구(삼선교),수,42763,44696,74954,162413,54138.0
한성대입구(삼선교),월,39506,40814,68123,148443,49481.0
한성대입구(삼선교),일,12806,32204,34047,79057,26352.0
한성대입구(삼선교),토,19190,43571,41676,104437,34812.0
한성대입구(삼선교),화,43619,42749,74477,160845,53615.0
한양대,금,40388,24605,15780,80773,26924.0
한양대,목,42236,24267,14227,80730,26910.0
한양대,수,49546,27441,16780,93767,31256.0
한양대,월,46752,25747,14982,87481,29160.0
한양대,일,4779,14091,10092,28962,9654.0
한양대,토,12215,16547,10560,39322,13107.0
한양대,화,49897,28660,16291,94848,31616.0
합정,금,152826,139927,205232,497985,165995.0
합정,목,157642,125531,175299,458472,152824.0
합정,수,181141,139821,202636,523598,174533.0
합정,월,171978,128306,175148,475432,158477.0
합정,일,38931,153592,95959,288482,96161.0
합정,토,59450,211914,135666,407030,135677.0
합정,화,181900,133837,194955,510692,170231.0
행당,금,11724,20373,48853,80950,26983.0
행당,목,11339,19388,49955,80682,26894.0
행당,수,13603,22561,57585,93749,31250.0
행당,월,12556,20493,53553,86602,28867.0
행당,일,5759,14183,18273,38215,12738.0
행당,토,9007,19736,23669,52412,17471.0
행당,화,13527,21893,58087,93507,31169.0
혜화,금,134654,107524,89295,331473,110491.0
혜화,목,136802,106796,76089,319687,106562.0
혜화,수,165897,122051,88757,376705,125568.0
혜화,월,153165,109210,65403,327778,109259.0
혜화,일,27543,122584,56072,206199,68733.0
혜화,토,45681,141641,68049,255371,85124.0
혜화,화,165184,113614,83737,362535,120845.0
홍대입구,금,129846,220869,250948,601663,200554.0
홍대입구,목,130776,192942,202983,526701,175567.0
홍대입구,수,151169,213949,234758,599876,199959.0
홍대입구,월,143671,198599,203890,546160,182053.0
홍대입구,일,41346,281174,134665,457185,152395.0
홍대입구,토,66926,371529,186944,625399,208466.0
홍대입구,화,150330,199930,224367,574627,191542.0
홍제,금,31230,50353,101588,183171,61057.0
홍제,목,31239,47662,99057,177958,59319.0
홍제,수,35934,56019,114958,206911,68970.0
홍제,월,34656,53147,107203,195006,65002.0
홍제,일,14225,34595,43636,92456,30819.0
홍제,토,22788,50973,58130,131891,43964.0
홍제,화,36892,54266,114807,205965,68655.0
화곡,금,38110,69202,188144,295456,98485.0
화곡,목,38502,64333,185280,288115,96038.0
화곡,수,43451,75484,214051,332986,110995.0
화곡,월,41853,70904,200771,313528,104509.0
화곡,일,14563,48860,76953,140376,46792.0
화곡,토,24877,71924,102234,199035,66345.0
화곡,화,43569,72929,214785,331283,110428.0
화랑대(서울여대입구),금,13818,20572,61885,96275,32092.0
화랑대(서울여대입구),목,13644,19346,62165,95155,31718.0
화랑대(서울여대입구),수,15627,22456,72446,110529,36843.0
화랑대(서울여대입구),월,14162,20286,68335,102783,34261.0
화랑대(서울여대입구),일,7090,15444,21830,44364,14788.0
화랑대(서울여대입구),토,10344,20516,28914,59774,19925.0
화랑대(서울여대입구),화,15395,21430,73136,109961,36654.0
회현(남대문시장),금,148917,86735,23178,258830,86277.0
회현(남대문시장),목,152240,80513,19507,252260,84087.0
회현(남대문시장),수,180461,96893,23773,301127,100376.0
회현(남대문시장),월,166552,90956,19962,277470,92490.0
회현(남대문시장),일,32740,43416,12094,88250,29417.0
회현(남대문시장),토,64911,100141,16167,181219,60406.0
회현(남대문시장),화,180303,95701,22068,298072,99357.0
효창공원앞,금,21901,18332,30125,70358,23453.0
효창공원앞,목,22579,17678,29070,69327,23109.0
효창공원앞,수,25693,20390,33690,79773,26591.0
효창공원앞,월,24387,18515,30888,73790,24597.0
효창공원앞,일,4764,13171,13891,31826,10609.0
효창공원앞,토,8195,17990,17825,44010,14670.0
효창공원앞,화,25617,19368,33204,78189,26063.0
